Ms^Xm, Ms^Xm, Ms^Xm, Mm^Xm, Ms^Xm, Mm^Xm, Mm^Xm, Mm^Qhh, Mm^Qhh, Mm^Qhh, Mm^Qhh, Ms^Qhh, Ms^Qhh, Mm^Qhh, Mm^Qhh, Hh^Qhh, Ww, Hh, Gs^Fp, Gs^Fp, Gs^Fp, Gs^Fp, Mm^Xm, Mm^Xm, Mm^Xm, Gs^Fp, Mm, Mm^Xm, Mm^Xm, Gs^Fp, Hh^Fp, Hh^Fp, Hh^Fp, Hh^Fp, Hh^Fp, Gs^Fp, Hh^Fp, Gs^Fp, Gs^Fp, Gs^Fp, Ms, Gs^Fp, Hh^Fp
Ms^Xm, Ms^Xm, Ms^Xm, Ms^Xm, Ms^Xm, Ms^Xm, Ms^Xm, Mm, Mm, Mm, Ms, Mm, Ms, Ms, Ms^Qhh, Ww, Ha^Fpa, Ha, Gs^Fp, Gs^Fp, Gs^Fp, Gs^Fp, Mm, Mm^Xm, Mm, Gs^Fp, Mm, Mm, Mm, Mm^Xm, Mm, Hh^Fp, Hh^Fp, Hh^Fp, Hh^Fp, Hh^Fp, Ms, Ms, Ms, Ms^Xm, Ms, Ms, Hh^Fp
Xu, Ms^Xm, Ms^Xm, Mm^Xm, Ms^Xm, Ms^Xm, Mm, Mm, Mm, Ms, Ms, Ms, Ha, Ms^Qhh, Ww, Ww, Ha, Ha^Fpa, Ha^Fma, Ha^Fma, Mm, Mm, Mm, Mm, Mm, Mm, Mm, Mm, Mm, Mm, Gs^Fp, Hh^Fp, Gs^Fp, Gs^Fp, Hh^Fp, Hh^Fp, Ha, Hh^Fp, Ms, Ms^Xm, Ms, Ha, Ms
Xu, Xu, Mm^Xm, Ms^Xm, Mm^Xm, Mm^Xm, Mm, Mm, Ms, Ms, Ms, Hh, Ha^Fpa, Ha^Qhh, Ww, Ha^Fpa, Ha^Fpa, Ha, Ha, Ha, Ha, Mm, Gs^Fp, Mm, Hh, Mm, Hh^Fp, Hh^Fp, Hh^Fp, Mm, Hh^Fp, Hh^Fp, Gs^Fp, Aa, Gs, Ha, Aa, Ha, Ha, Ms, Ms, Ms, Ms
Xu, Xu, Mm^Xm, Mm^Xm, Mm, Mm, Mm, Ms, Mm, Ms, Mm, Hh, Gs^Qhhf, Ha^Qhh, Ww, Ha, Ha, Ha^Fpa, Hh^Fp, Hh, Hh, Ha, Hh^Fp, Hh^Fp, Hh, Hh, Gg^Fp, Hh^Fp, Gs^Fp, Gs^Fp, Gs^Fp, Gs^Fp, Gs^Fp, Gs, Gs^Fp, Gs^Fp, Gs^Fp, Aa, Gg, Ha, Hh^Fp, Hh^Fp, Hh^Fp
Xu, Xu, Xu, Mm^Xm, Mm, Mm, Mm, Mm, Hh, Mm, Hh^Fp, Hh^Fp, Hh^Qhh, Ww, Ww, Gs^Fp, Gs^Fp, Gs^Fp, Gs^Fp, Gs^Fp, Hh, Hh, Hh, Gs, Rb^Gvs, Gs, Gs, Gs^Fp, Gs^Fp, Gs^Fp, Re^Vl, Gs^Fp, Gs^Fp, Gs^Fp, Gs^Fp, Gs^Fp, Gs^Fp, Gg^Efm, Gg^Efm, Gg^Efm, Hh^Qhhf, Gs^Qhhf, Gs^Qhhf
Xu, Xu, Xu, Mm^Xm, Ms^Xm, Mm, Mm, Mm, Hh, Hh, Hh, Hh^_mh, Gs^Fp, Gs^Qhhf, Gs^Qhhf, Ww, Gs^Fp, Gs^Fp, Gg, Gg, Re^Eff, Hh, Re^Gvs, Rb^Gvs, Rb^Gvs, Rb^Gvs, Re, Gs, Gs, Gs, Gs^Fp, Gs^Fp, Hh^Fp, Gs^Fp, Hh^Fp, Gs^Fp, Hh, Gs^Fp, Gs^Qhhf, Hh^Qhhf, Hh^Fp, Hh^Fp, Mm
Xu, Xu, Ms^Xm, Ms^Xm, Ms, Ms, Ms, Mm, Hh, Hh, Aa^Fma, Aa^Fma, Aa^Fpa, Gs^Fp, Gs^Qhhf, Ww, Ww, Gs^Fp, Re^Eff, Re^Eff, Rb^Gvs, Rb^Gvs, Rb^Gvs, Rb^Gvs, Rb^Gvs, Rb^Gvs, Hh^Qhh, Hh^Qhh, Hh^Qhhf, Gs, Hh^Qhhf, Hh^Qhhf, Ha^Qhh, Hh^Qhhf, Hh^Qhh, Hh, Hh^Qhh, Hh^Qhhf, Hh, Hh^Fp, Mm, Mm^Xm, Mm
Xu, Xu, Mm^Xm, Ms^Xm, Ms, Ms, Ms, Mm^Qhh, Hh, Hh, Aa^Fma, Aa^Fma, Aa, Gs^Fp, Hh, Gs^Qhhf, Hh^Qhh, Ww, Re, Rb^Eff, Rb^Gvs, Rb^Gvs, Rb^Gvs, Re^Gvs, Re^Gvs, Hh, Ha^Qhh, Ha, Ms^_mh, Hh^Qhhf, Ha^Vhha, Ha, Ms, Ms, Ms, Ms^Qhh, Ha, Hh, Hh, Hh^Fp, Mm, Mm, Hh^Fp
Xu, Xu, Xu, Mm^Xm, Mm^Xm, Ms^Xm, Mm, Mm^Qhh, Hh^Vhh, Aa, Aa^Fpa, Aa, Hhd, Hh, Hh, Hh, Hh^Qhh, Ww, Rb^Vh, Re, Rb^Gvs, Re^Gvs, Re^Gvs, Re^Gvs, Re^Gvs, Gs, Hh, Ha^Qhh, Ms^Qhh, Ms, Ms, Ms, Ms, Ms, Ms, Mm, Hh, Mm^Qhh, Mm^Qhh, Mm, Hh^Qhhf, Hh^Qhhf, Hh^Qhhf
Xu, Xu, Xu, Xu, Xu, Xu, Xu, Mm^Qhh, Mm^Qhh, Aa^Fma, Gll^Fp, Gll, Hhd, Hhd, Re^Qhh, Hh^Qhh, Re, Wwf, Re, Rb^Eff, Rb^Eff, Rb^Gvs, Rb^Gvs, Rb^Gvs, Re^Gvs, Rb^Vh, Re, Hh, Hh^Qhh, Ha^Qhh, Hh^Qhh, Mm, Hh^Qhh, Mm, Ha^Qhh, Ha^Qhh, Ha^Qhh, Hh^Qhh, Rb, Hh^Qhh, Hh, Gs^Fp, Gs^Fp
Xu, Xu, Xu, Xu, Xu, Xu, Mm^Xm, Mm^Xm, Md, Mm^Qhh, Hhd^Qhh, Gd^Fp, Re^Qhh, Re^Qhh, Rb^Gvs, Re, Rb^Gvs, Wwf, Wwf, Re, Rb^Gvs, Rb^Gvs, Rb^Gvs, Re^Gvs, Rb^Gvs, Re^Gvs, Rb^Gvs, Re, Re, Hh, Re, Hh^Qhh, Gs, Hh^Qhh, Gs, Gs^Fp, Rb^Vwm, Rb, Rb^Gvs, Rb^Gvs, Rb^Gvs, Re, Re
Uhe^Qhh, Xu, Xu, Xu, Xu, Xu, Xu, Md, Hhd, Hhd, Gll^Fp, Gd^Qhh, Re, Re^Gvs, Rb^Gvs, Rb^Gvs, Rb^Gvs, Re^Qhh, Ww, Gg, Gg, Rb^Gvs, Rb^Gvs, Rb^Gvs, Rb^Gvs, Rb^Gvs, Re^Gvs, Rb^Eff, Re^Eff, Re^Eff, Re^Gvs, Re^Gvs, Re^Gvs, Gs, Re, Rb^Gvs, Rb^Gvs, Rb^Gvs, Re^Gvs, Re^Gvs, Re^Gvs, Gll^Fp, Gll^Fp
Uhe^Qhh, Uhe^Qhh, Xu, Xu, Xu, Xu, Xu, Hhd, Gd, Gd, Re, Re, Rb, Rb^Gvs, Gs, Re^Gvs, Hh, Hh^Qhh, Hh^Qhh, Ww, Ww, Gg, Gs, Re^Vwm, Re, Re, Gg^Eff, Rb^Eff, Re^Gvs, Re^Gvs, Re^Gvs, Re^Gvs, Re^Gvs, Re^Gvs, Re, Rb^Gvs, Rb^Gvs, Re^Gvs, Re^Gvs, Re^Gvs, Rb^Eff, Gll^Fp, Gll^Fp
Xu, Uh, Uu^Emf, Uue^Qhu, 1 Kud, Cud, Uu, Cud^Xo, Gd, Gd, Re, Gs, Gs, Hh, Hh, Hh, Mm, Hh, Mm, Mm^Qhh, Ww, Re^Gvs, Re^Gvs, Re^Gvs, Re^Gvs, Re^Gvs, Gs, Re^Gvs, Re^Gvs, Re^Gvs, Re^Gvs, Re^Gvs, Gs, Gg^Efm, Rb, Rb, Re^Gvs, Re^Gvs, Rb, Rb^Eff, Gll^Fp, Gll^Fp, Gll^Fp
Uu^Emf, Uu^Vu, Ur, Ur, Cud, Cud, Rr, Rr, Rr, Re, Gd, Re, Rb, Hh, Hh, Mm, Mm, Mm, Mm, Mm^Qhh, Mm^Qhh, Ww, Ww, Re^Gvs, Re^Gvs, Re^Gvs, Re^Gvs, Gs, Re^Vh, Re^Gvs, Re^Gvs, Gs^Fp, Gs, Gg^Efm, Gs^Fp, Rb, Gs, Gll^Fp, Gll^Fp, Gll^Fp, Gll^Fp, Gll^Fp, Gll^Fp
Ur, Ur, Uue^Qhu, Uu, Tb^Tf, Uu, Cud^Xo, Gs, Gs, Gs, Gd, Re, Rb, Gd, Gd, Hh, Hh, Hh^Vhh, Mm, Mm, Mm^Qhh, Hh^Qhh, Ww, Rb^Gvs, Rb^Gvs, Rb^Gvs, Rb^Gvs, Re^Gvs, Re^Gvs, Re, Gs^Fp, Gs^Fp, Gs^Fp, Gs^Fp, Gs^Fp, Gs, Rb, Gll^Fp, Gs, Gll^Fp, Gs^Fp, Gll^Fp, Gll^Fp
Xu^Qhh, Xu, Uhe^Qhh, Uue^Qhu, Xu^Qhh, Xu^Qhh, Xu^Qhh, Hhd^Qhh, Hhd^Qhh, Hhd^Qhh, Hhd^Qhh, Gs, Gll^Fp, Re, Re, Hh, Gs, Hh, Hh^Qhh, Hh^Qhh, Aa^Fpa, Hh^Qhh, Aa, Ww, Rb^Gvs, Rb^Gvs, Re^Gvs, Rb^Gvs, Rb, Rb, Gs, Gs^Fp, Gs^Fp, Gs^Fp, Gs^Fp, Gs^Fp, Rb, Gs, Gs, Gll^Fp, Gll^Fp, Gll^Fp, Gll^Fp
Xu^Qhh, Xu^Qhh, Xu^Qhh, Tb^Tf, Xu^Qhh, Xu, Xu, Md, Md, Hhd, Hhd^Qhh, Gd, Gll^Fp, Gs, Gs, Gs, Rb, Hh^Qhh, Aa^Fma, Aa^Fma, Aa^Fpa, Aa^Fma, Aa^Fma, Ww, Rb^Gvs, Re^Gvs, Aa, Rb, Aa, Gs, Gg^Fp, Gs, Gs^Fp, Gs^Fp, Gs^Fp, Gs^Fp, Re, Rb^Vhr, Gs, Gll^Fp, Re, Re, Re
Xu^Qhh, Xu, Xu, Xu^Qhh, Xu, Xu, Mm^Xm, Mm^Xm, Mm, Md, Mm, Hh^Qhh, Gs^Fp, Gs^Fp, Gs^Fp, Gs, Gs, Gs, Aa, Aa^Fpa, Aa^Fma, Aa^Fma, Aa^Fpa, Ww, Ww, Rb^Gvs, Aa, Aa, Aa, Gg^Fp, Gg^Fp, Gg, Gg, Gg, Gg, Gg, Gg, Re, Re, Re, Gll^Fp, Gll^Fp, Gll^Fp
Xu^Qhh, Xu, Xu, Xu, Xu, Xu, Mm^Xm, Mm, Mm, Mm, Mm, Hh^Qhh, Gs^Fp, Gs^Fdw, Gs^Fp, Gs^Fp, Gs^Fp, Aa, Aa, Aa, Aa^Fpa, Aa^Fpa, Aa^Fpa, Aa^Fma, Gs^Fp, Ww, Wwf, Aa, Aa, Gg^Fp, Gs, Gg^Fp, Gs, Gs, Gs, Gg, Re, Gg^Edb, Gll^Fp, Gll^Fp, Gs^Fp, Gll^Fp, Gll^Fp
Xu^Qhh, Xu, Xu, Xu, Xu, Ms^Xm, Ms^Xm, Mm, Mm, Mm, Mm, Hh^Qhh, Hh^Qhhf, Gs^Fp, Gs^Fp, Gs^Fp, Gs^Fp, Gs, Aa^Fma, Aa^Fpa, Aa, Aa, Gs^Fp, Gs^Fp, Gs^Fp, Gs, Aa^Vha, Wwf, Ww, Ww, Ww, Gs, Gll^Fp, Gs, Gg, Gg, Gll^Fp, Rb, Gll^Fdw, Gll^Fp, Gll^Fp, Gll^Fp, Gll^Fp
Xu^Qhh, Xu, Ms^Xm, Ms^Xm, Ms^Xm, Ms^Xm, Ms^Xm, Ms, Mm, Mm, Mm, Hh, Hh^Qhh, Gs^Fp, Gg, Gs^Fp, Gs^Fp, Gs^Fp, Aa^Fpa, Aa^Fma, Gs, Aa, Gs, Gs, Gs, Aa, Aa^Fma, Aa, Aa, Gs, Ww, Gg^Fp, Re^Vl, Gll^Fp, Gll^Fp, Gll^Fp, Gs^Fp, Rb, Re, Gll^Fp, Cer, Cer, Gll^Fp
Xu^Qhh, Xu, Ms^Xm, Ms^Xm, Ms, Ms^Xm, Ms^Xm, Ms, Ms, Ms, Mm, Mm, Hh^Qhh, Gg, Aa, Re^Vl, Gs^Fp, Gs^Fp, Gs^Fmw, Aa^Fpa, Gs^Fp, Gs, Gs, Gs, Aa, Aa, Gs^Fmw, Gs^Fmw, Aa^Fpa, Aa^Fpa, Gs, Wwf, Gg^Fp, Gll^Fp, Gll^Fp, Gll^Fp, Cer, Gd^Fetd, Re, Gll^Fp, Gd, Cer, Gll^Fp
Xu, Xu, Ms^Xm, Ms, Mm, Ms, Ms, Ms, Ms, Ms, Mm^_mhh, Mm, Ha^Qhh, Ha, Ha, Aa, Gs^Fp, Gs^Fp, Gs^Fp, Gs^Fp, Gs^Fp, Gs, Gs, Aa, Aa, Aa, Aa, Aa^Fma, Aa^Fpa, Aa, Aa^Fpa, Wwf, Gll^Fp, Gll^Fp, Gll^Fp, Gll^Fp, Gll^Fdw, Re, Gd^Ecf, Cer, Ker, Gll^Fdw, Gll^Fdw
Xu, Ms^Xm, Ms, Mm, Mm, Ms, Ms, Ms, Ms, Ms, Mm, Hh, Ha, Ha^Qhh, Ha, Ha, Aa, Gs^Fp, Aa^Fpa, Gs^Fp, Gs, Gs, Gs, Gs^Fp, Aa^Fpa, Aa, Aa^Fma, Aa^Fpa, Aa^Fpa, Aa^Fpa, Gs, Ww, Ww, Gll^Fp, Gll^Fp, Gs^Edb, Gll^Fp, Re, Gll^Fdw, Cer, Cer, Gll^Fdw, Cer
Ms^Xm, Ms^Xm, Mm, Hh, Hh, Ms, Ms^Xm, Ms, Ha, Mm, Hh^Qhh, Hh^Qhh, Hh^Qhh, Ha^Qhh, Ha, Aa, Aa, Aa, Aa, Aa, Aa^Eff, Gs^Eff, Gs^Eff, Aa^Fpa, Aa^Fpa, Aa^Fpa, Aa^Fma, Aa^Fpa, Aa^Fma, Aa, Hh, Hh, Hh, Ww, Gll^Fp, Gll^Fp, Gll^Fp, Rr, Re, Gll^Fdw, Gll^Fp, Gll^Fp, Gll^Fp
Mm, Ms, Mm, Hh, Hh, Hh, Ha, Ha, Hh, Ha^Qhh, Ha, Ha, Aa, Aa^Fpa, Aa, Aa, Aa, Aa, Gs^Eff, Aa^Eff, Rb^Gvs, Rb^Gvs, Gs, Gs^Fp, Gs^Fp, Aa, Aa, Aa^Fma, Aa, Aa^Fma, Aa^Fma, Hh, Hh, Ww, Gs^Fp, Gs^Fp, Gll^Feth, Gll^Fp, Re, Gd, Gll^Fp, Gll^Fp, Gll^Fp
Mm, Mm, Mm, Mm, Hh, Hh, Hh, Ha, Hh^Qhh, Hh^Qhh, Aa, Aa, Aa^Fma, Aa^Fpa, Aa^Fpa, Gs, Aa^Fpa, Gs, Rb^Gvs, Rb^Gvs, Re^Gvs, Re^Gvs, Re^Gvs, Re^Gvs, Rb^Vh, Aa, Aa, Aa, Aa, Aa^Fma, Aa^Fma, Hh, Ww, Ww, Gs^Fp, Gs^Fp, Gs^Fp, Gd^Edb, Gs^Fp, Re, Rr, Gs^Fp, Gll^Fp
Hh, Mm, Hh, Hh, Hh, Hh, Hh^Qhh, Hh^Qhh, Aa, Aa, Aa^Fma, Aa^Fma, Aa^Fma, Aa^Fpa, Aa^Fma, Aa^Fma, Gs^Fp, Gs, Rb^Gvs, Rb^Gvs, Re^Gvs, Re^Gvs, Re^Gvs, Re^Gvs, Re^Gvs, Rb, Gs, Gs^Fp, Gs^Fp, Gg^Fp, Gg^Fp, Ww, Gs^Fp, Gs^Fp, Gs^Fp, Gs^Fp, Gs^Fp, Gs^Fp, Gs^Fp, Gs^Fp, Gd^Vo, Rb, Rb
Hh, Hh, Ha, Ha, Ha, Ha, Ha^Qhh, Gs, Aa, Aa, Aa^Fma, Aa^Fpa, Aa^Fma, Aa^Fma, Aa^Fma, Gs^Fp, Rb, Re^Wm, Rb^Gvs, Rb^Gvs, Rb^Gvs, Re^Gvs, Re^Gvs, Rb^Gvs, Rb^Gvs, Re^Gvs, Re, Gs, Gs^Fp, Gg^Fp, Ww, Wwf, Gs^Fp, Gs^Fp, Gs^Edb, Gs^Fp, Gs^Fp, Gs^Fp, Gs^Fp, Gs^Fp, Gs^Fp, Gs^Dr, Gs^Fp
Ha, Ha, Ha, Ha, Hh, Ha, Ha^Qhh, Ha, Ha, Aa, Aa^Fpa, Aa^Fpa, Aa^Fpa, Aa^Fpa, Rb, Rb, Rb^Gvs, Rb^Gvs, Rb^Gvs, Re^Gvs, Re^Gvs, Re^Gvs, Rb^Gvs, Re^Gvs, Re^Gvs, Re^Gvs, Gs, Re, Gs, Gg^Fp, Ww, Gs^Fp, Gs^Fp, Gs^Fp, Gs, Gs, Gs^Fp, Gs^Fp, Gs^Fp, Gs^Fp, Gs^Fp, Gs^Fp, Gs^Fp
