Rb^Gvs, Rb^Gvs, Mm, Rb, Mm, Gg, Mm, Gg, Mm, Gg, Sm, Ww, Hh, Gg, Mm, Gg, Mm, Gg, Mm, Mm, Mm, Gg, Hh, Rp, Hh, Hh, Hh, Gg, Gs^Fp, Gg, Gg, Gg, Gg, Gg, Gs^Fms, Gg, Gg
Gg, Mm, Mm, Mm, Mm, Mm, Mm, Mm, Mm, Hh, Wwf, Wwf, Hh, Mm, Mm, Mm, Mm, Mm, Mm, Mm, Hh^Fp, Hh, Rb, Rb, Gg^Efm, Hh, Gg, Gs^Fp, Gs^Fp, Gs^Fp, Gs^Fms, Gg, Gg, Gs^Fms, Gs^Fms, Gs^Fms, Gs^Fms
Mm, Mm, Mm, Mm, Hh, Hh, Hh, Mm, Hh, Hh^Qhh, Hh^Qhh, Wwf, Hh, Mm, Hh^Fms, Hh^Fp, Hh^Fp, Mm, Hh^Fms, Hh^Fp, Hh^Fp, Hh^Fp, Gg, Rb, Gg^Efm, Gg^Efm, Gg^Vl, Gs^Fms, Gs^Fp, Gs^Fp, Gs^Fp, Gs^Fms, Gs^Fp, Gg, Gs, Gs^Fms, Gs^Fms
Mm, Mm, Mm, Mm, Hh, Hh, Gg, Hh, Re^Gvs, Hh, Hh^Qhh, Ww^Ewf, Ww^Ewl, Hh^Fp, Hh^Fp, Hh^Fp, Gs^Fp, Hh^Fms, Gs^Fp, Hh^Fms, Gs^Fp, Gs^Fp, Gg, Gg, Gg, Gg, Hh, Hh, Gs, Gs^Fp, Gs^Fp, Gs^Fms, Gs^Fp, Gg^Edb, Gs, Gs^Fp, Gs^Fp
Mm, Mm, Hh^Es, Hh, Rb^Wm, Gg, Re^Gvs, Re^Gvs, Re^Gvs, Gg^Vh, Hh, Hh^Qhh, Hh^Qhh, Ww, Ww, Gg, Gg, Gs^Fp, Gs^Fp, Gs^Fms, Gs^Fp, Gg, Gg, Rb, Gg, Hh, Hh, Hh, Hh, Gs, Gs^Em, Gs^Fp, Gs, Gs, Gs, Gs^Fp, Gs^Fp
Hh, Hh, Hh, Hh, Gg, Rb, Re^Gvs, Re^Gvs, Rb^Gvs, Re^Gvs, Re^Gvs, Gll^Fp, Hh^Fp, Hh^Qhh, Hh^Qhh, Ww, Gg, Gg, Gg, Gs^Fp, Hh^Fp, Hh^Fp, Hh, Re, Gg, Hh, Hh, Hh, Hh^Fp, Hh^Fp, Gs^Fp, Gs^Fp, Gs^Fp, Gs^Fp, Gg, Gs, Gs
Mm, Hh, Mm, Hh, Hh, Rb, Rb, Rb^Gvs, Rb^Gvs, Rb^Gvs, Gll^Fp, Gll^Fp, Gll^Fp, Hh^Fp, Gs^Qhh, Ww, Ww, Gg, Gg^Vhh, Hh, Hh^Fp, Hh^Fp, Hh, Gg, Rp, Hh, Hh, Gs, Hh^Fp, Gs^Fp, Gs^Fp, Gs^Fp, Gs^Fp, Gg, Cer^Edt, Gs^Edt, Gs^Edt
Mm, Mm, Mm, Hh, Gg^Efm, Hh, Gg, Rb^Gvs, Gg, Gll^Fp, Gll^Fp, Gll^Fp, Gg, Gll, Hh^Gvs, Hh^Qhh, Wwf, Gg, Hh, Hh, Hh, Hh^Fp, Gg, Gg, Re, Re, Hh^Fp, Hh^Fp, Gs^Fp, Gs^Fp, Gg^Efm, Gs, Gs, Cer^Edt, 3 Ker, Cer, Gs
Mm, Mm, Hh, Hh^Efm, Gs^Fp, Hh, Hh, Gg, Gg, Gll^Fp, Gll^Fp, Gll^Fp, Gg^Efm, Gll^Efm, Hh^Qhh, Hh^Vhh, Ww^Ewf, Gg, Rb^Gvs, Hh, Rb^Gvs, Hh, Gg, Gg, Hh, Rb, Gs^Fp, Gs^Fms, Gg^Vl, Gs^Fms, Gs^Fp, Cer, Gg, Gg, Gg, Cer^Edt, Gs^Edt
Hh, Hh, Gs^Fp, Gs, Gs, Gs^Fp, Hh, Hh, Gg, Gg, Gg, Gg, Hh^Gvs, Hh^Gvs, Hh^Qhh, Wwr, Ww, Rb^Gvs, Rb^Gvs, Rb^Gvs, Rb^Gvs, Rb^Vhr, Rb^Gvs, Re^Gvs, Re^Gvs, Rb, Gg, Gs^Fp, Gs^Fp, Gs^Fp, Gs^Fms, Gg^Edt, Gg, Cer, Cer, Gg, Gg
Hh, Hh, Gs, Gs, Gs, Gs, Gg, Hh, Gg, Gg, Gg, Hh^Gvs, Hh^Gvs, Hh^Qhh, Wwr, Ww, Ww, Ww^Wkf, Ww^Wkf, Rb^Gvs, Rb^Gvs, Re^Gvs, Re^Gvs, Re^Gvs, Re^Gvs, Rp, Gg, Gg, Gg, Gs^Fp, Rb, Gg, Gg, Cer^Edt, Gg, Gg, Rp
Rp, Gg, Gs, Ce, 1 Ke, Ce, Gg, Gg, Gg, Gg, Gg, Hh^Gvs, Hh^Gvs, Hh^Qhh, Ww, Ww, Mm, Ww, Ww, Rb^Gvs, Rb^Gvs, Re^Gvs, Re^Gvs, Re^Gvs, Rb, Rb, Rb, Gg, Rr, Rr, Rb^Gvs, Rb, Rb, Gg, Re^Edt, Re^Edt, Gg
Gg, Rb, Rb^Qhh, Rb^Qhh, Ce, Ce, Gg^Qhh, Gg, Gg^Qhh, Gg^Qhh, Gg^Qhh, Gg, Ww, Ww, Hh^Fp, Mm, Hh^Fp, Mm, Mm, Ww, Ww, Rb^Gvs, Rr, Rr, Hh, Hh, Hh, Rr, Re^Gvs, Re^Gvs, Re^Gvs, Re^Gvs, Gg, Re, Hh, Hh^Edt, Gg
Gg, Gg, Gs^Fp, Re^Qhh, Rb^Qhh, Gg^Qhh, Gg, Gg^Qhh, Hh^Fp, Hh^Fp, Hh^Qhh, Ww, Gg, Hh, Gs^Fp, Hh^Fp, Hh^Fp, Hh^Vhh, Hh^Fp, Hh, Rr, Ww^Bw/, Ww^Ewl, Mm^Qhh, Mm^Qhh, Mm, Hh^Vhh, Re^Gvs, Re^Gvs, Re^Gvs, Re^Gvs, Re^Gvs, Hh, Hh, Hh^Fp, Hh, Hh
Gg^Qhh, Gg, Gg, Gs^Fp, Gg, Gg, Rr, Gg, Hh^Fp, Hh^Vhh, Re^Qhh, Ww, Gs, Gs^Fp, Gs^Fp, Gs^Fp, Gs^Fp, Gg, Re, Re, Rb^Gvs, Rb^Gvs, Rb^Gvs, Ww, Ww, Mm^Qhh, Hh, Re^Gvs, Re^Gvs, Re^Gvs, Gg, Gg^Vhr, Hh^Fp, Hh^Fp, Gll^Fp, Hh^Fp, Gg^Fp
Gg^Qhh, Gg, Hh, Gg, Gg, Gg^Efm, Gg^Efm, Rr, Re, Rb, Gg^Qhh, Ww^Bw\, Gs, Gs, Gs, Gs, Gs, Gs, Re^Gvs, Re^Gvs, Re^Gvs, Rb^Gvs, Rb^Gvs, Gg, Ww, Hh^Qhh, Hh, Hh, Gg, Gg, Gg, Hh^Fp, Gll^Fp, Gll^Fp, Gll^Fp, Gll^Fp, Gg^Fp
Gg^Qhhf, Gs^Fp, Gs^Fp, Hh, Hh, Gg, Gg^Efm, Gg, Gg, Gs^Qhh, Ww, Ww, Gg, Rb, Rb, Rr, Re^Vwm, Rb^Gvs, Re^Gvs, Re^Gvs, Rb^Gvs, Rb^Vhr, Gs^Fp, Gg, Ww, Hh^Qhh, Gg, Gg, Gll^Fp, Gg, Gll^Fp, Gll^Fp, Gll, Gll^Fp, Gll^Fp, Gll^Fp, Gg^Fp
Gg^Qhhf, Gs^Fp, Gs^Fp, Hh, Hh, Hh, Gg, Gg, Gg^Qhh, Gg^Qhh, Ww, Ww, Rb^Gvs, Gg, Rp, Gg, Re, Re^Gvs, Re^Gvs, Re^Gvs, Gg^Eff, Gs^Eff, Hh, Hh, Wwf, Gg^Qhh, Gg, Gll^Fp, Hh^Fp, Gll^Fp, Hh^Fp, Gll^Fp, Gs, Gll^Fp, Gll^Fp, Gll^Fp, Gll
Gg^Qhhf, Gs^Fp, Gs^Fp, Gs^Fp, Hh, Gg, Gg^Qhh, Gg^Qhh, Ww, Ww, Ww, Rb^Gvs, Re^Gvs, Rb^Gvs, Gs^Fp, Gg^Edt, Gll^Fp, Re^Gvs, Co^Edt, Gg^Eff, Rb^Gvs, Rb^Gvs, Re^Gvs, Gg, Ww, Hh^Qhh, Hh^Qhh, Hh^Fp, Gll^Fp, Gll^Fp, Hh^Fp, Hh^Fp, Gs, Gs, Gll^Fp, Gll, Gll
Gg^Qhh, Gs^Fp, Gg, Gg, Gg^Qhh, Gg^Qhh, Ww, Wwf, Wwf, Ww, Re^Gvs, Re^Gvs, Re^Gvs, Rb^Gvs, Gs^Eff, Gs^Fp, Gll^Fp, Gll^Fp, Gll^Fp, Re^Edt, Re^Gvs, Rb^Gvs, Re^Gvs, Rb^Gvs, Rb^Gvs, Ww, Ww, Hh^Qhh, Gg, Gs^Qhh, Gs, Gs, Gs, Gll^Fp, Gll^Fp, Gll^Fp, Gg^Fp
Gg^Qhh, Gg, Gg, Gg, Gg^Qhh, Ww, Ww, Wwf, Re^Gvs, Re^Gvs, Re^Gvs, Re^Gvs, Gs^Vo, Gs^Eff, Gs, Gs^Fp, Gs^Fp, Gll^Fp, Gll^Fp, Re^Gvs, Re^Gvs, Re^Gvs, Re^Gvs, Re^Gvs, Re^Gvs, Ww, Ww, Hh^Qhh, Hh, Gg^Qhh, Gs^Qhh, Gs, Gg, Gll^Fp, Gll^Fp, Gll^Fp, Gs
Gg^Qhh, Gg^_mh, Gg^Qhh, Gg^Qhh, Ww^Ewl, Ww, Rb^Gvs, Rb^Gvs, Rb^Gvs, Rb^Gvs, Gg^Eff, Gs^Eff, Gs, Gs^Eff, Gs^Eff, Gs^Fp, Gs^Fp, Gll^Fp, Gll^Fp, Gs^Fp, Gs, Re^Gvs, Re^Gvs, Re^Gvs, Re^Gvs, Re^Gvs, Ww, Hh^Qhh, Hh^Qhh, Hh, Gs^Qhh, Gs, Gg, Gg, Gg, Gg, Gg
Gg^Qhh, Gg^Qhh, Ww, Ww, Ww, Ww, Gg^Eff, Rb^Gvs, Gg^Eff, Gg^Efm, Gg^Efm, Gg^Efm, Gg^Efm, Gg^Efm, Co, Co, Gs^Efm, Gs^Fp, Gll^Fp, Gs^Fp, Gll^Fp, Gs, Gs, Gs^Vo, Re^Gvs, Re^Gvs, Gg, Ww, Hh^Qhhf, Gg^_mh, Gs^Qhhf, Gs^Vhh, Gg^Efm, Gg, Gg^Efm, Gg, Gg
Ww, Ww, Ww, Ww, Ds, Gg, Gg, Gg^Eff, Gg, Gg^Efm, Rb^Gvs, Gg^Efm, Gg, Gg, Rb, 2 Ko, Gs^Edt, Co^Edt, Re^Gvs, Rb^Gvs, Re^Gvs, Re^Gvs, Re^Gvs, Re^Gvs, Re^Gvs, Gg, Gg, Ww, Gs^Qhhf, Gs^Fp, Gs^Qhhf, Gg, Re, Gg^Efm, Rb^Gvs, Rb^Gvs, Re
Ww, Ww^Ewl, Ds, Ds, Gg^Efm, Gg, Gg, Gg, Rb^Gvs, Rb^Gvs, Rb^Gvs, Rb^Gvs, Re^Gvs, Rb^Gvs, Rb^Gvs, Re^Gvs, Re^Gvs, Gg^Vo, Rb^Gvs, Rb^Gvs, Rb^Gvs, Rb^Gvs, Rb^Gvs, Re^Gvs, Re^Gvs, Gg, Re, Wwf, Wwf^Ewl, Gs^Qhhf, Re, Re, Rb^Gvs, Rb^Gvs, Rb^Gvs, Re^Gvs, Re^Gvs
Ds, Ds, Ds, Gg, Gg, Gg^Efm, Rb, Rb^Gvs, Rb^Gvs, Rb^Gvs, Re^Gvs, Re^Gvs, Re^Gvs, Re^Gvs, Rb^Gvs, Rb^Gvs, Rb^Gvs, Re^Gvs, Re^Gvs, Re^Gvs, Re^Gvs, Rb^Gvs, Rb^Gvs, Re^Gvs, Re^Gvs, Re, Re, Re, Wwf, Re, Gg, Gg, Re^Gvs, Rb^Gvs, Re^Gvs, Re^Gvs, Rb^Gvs
Gg, Ds, Gg, Gg, Gg, Rb, Re^Gvs, Re^Gvs, Re^Gvs, Re^Gvs, Re^Gvs, Re^Gvs, Rb^Gvs, Rb^Gvs, Rb^Gvs, Rb^Gvs, Rp, Rb^Gvs, Rb^Gvs, Rb^Gvs, Re^Gvs, Re^Gvs, Rb^Gvs, Rb^Gvs, Rb^Gvs, Re^Gvs, Gg, Gg, Gg, Wwf, Gg, Rb^Gvs, Re^Gvs, Re^Gvs, Re^Gvs, Re^Gvs, Re^Gvs
