Hh, Hh, Hh, Hh, Hh, Ms^Xm, Hh, Mm^Qhh, Hh^Qhh, Mm^Qhh, Mm^Qhh, Mm^Qhh, Mm^Qhh, Mm^Qhh, Mm^Qhh, Mm^Qhh, Mm^Qhh, Mm^Qhh, Mm^Qhh, Mm^Qhh, Mm^Qhh, Mm^Qhh, Mm^Qhh, Mm^Qhh, Hh^Qhh, Hh^Qhh, Hh^Qhh, Aa^Qhhf, Aa^Qhhf, Gs^Qhhf, Aa^Qhhf, Gs^Fpa, Gs^Fp, Gs^Fp, Gs^Fp, Gs^Fp, Aa^Fpa, Gs^Fpa, Aa^Fpa, Gs^Fp, Gs^Fp, Gs^Fp, Aa^Fpa, Aa^Fpa, Aa, Gs^Fp, Aa^Fpa
Ms^Xm, Mm, Mm, Hh, Hh, Mm, Hh, Hh, Hh, Hh^Qhh, Hh^Qhh, Hh, Hh^_mh, Mm, Mm, Mm, Hh, Mm, Mm, Mm, Mm, Mm, Mm, Mm, Mm, Hh, Hh, Aa^Fpa, Hh, Aa^Fpa, Hh, Gs^Qhhf, Gs^Qhhf, Gs^Fp, Gs^Fp, Aa^Fpa, Gs^Fp, Aa^Fpa, Aa^Fpa, Aa^Fpa, Aa, Aa^Fpa, Gs^Fp, Gs^Fp, Aa^Fpa, Aa^Fpa, Aa^Fpa
Ms^Xm, Mm, Ms^Xm, Gs^Fp, Gs^Fp, Gs^Fp, Gs^Fp, Gs^Fp, Gs^Fp, Gs^Fp, Gs^Fp, Hh^Qhh, Hh^Qhh, Hh^Qhh, Hh^Qhh, Mm, Hh^Qhh, Hh, Hh, Mm, Mm, Mm, Mm, Mm, Mm, Mm, Mm, Hh, Hh, Gs^Fp, Mm, Hh^Fp, Hh^Fp, Hh^Qhhf, Hh^Fp, Hh^Fp, Hh^Fp, Aa^Fp, Gs^Fp, Aa^Fpa, Gs^Fp, Aa^Fpa, Aa^Fpa, Aa^Fpa, Aa^Fet, Gs^Fp, Aa^Fpa
Ms^Xm, Mm, Hh, Gs^Fp, Gs^Fp, Gs^Fp, Gs^Fp, Gs^Fp, Gs^Fp, Hh, Aa^Fpa, Hh, Hh, Hh, Hh, Hh^Qhh, Gs^Fp, Hh^Qhh, Hh^Qhh, Hh, Mm, Mm, Mm, Mm, Mm, Ms^Xm, Ms^Xm, Mm^_mh, Ms^Xm, Mm, Mm, Mm, Mm, Hh^Qhhf, Hh^Qhhf, Hh^Fp, Gs^Fp, Gg^Fet, Gg, Gg, Gs^Vl, Gs^Fp, Aa^Fpa, Aa^Fpa, Aa^Fpa, Aa^Fpa, Gs^Fp
Ms^Xm, Ms^Xm, Mm, Hh, Ms, Hh, Mm, Hh^Vl, Mm, Hh, Aa^Fpa, Gs^Fp, Hh, Mm, Gs^Fp, Gs^Fp, Gs^Fp, Hh, Hh^Qhh, Hh^Vl, Hh, Hh, Hh, Mm, Mm, Ms^Xm, Ms, Ms, Ms, Mm, Ms^Xm, Mm, Mm, Mm, Mm, Hh^Qhhf, Gs^Fp, Aa, Aa^Fpa, Gg, Gs^Fp, Gs^Fp, Aa^Fp, Aa^Fpa, Aa^Fpa, Aa^Fpa, Gs^Fp
Mm, Ms^Xm, Ms, Ms^Xm, Ms, Ms, Ms, Mm, Aa^Fpa, Aa^Fpa, Aa^Fpa, Aa^Fpa, Gs^Fp, Hh, Gs^Fp, Gg, Gs^Fp, Hh, Mm, Hh^Qhh, Gs^Fp, Hh, Hh, Ha, Cfr, Mm, Mm, Ms, Ms, Ms^Xm, Ms^Xm, Ms^Xm, Ms^Xm, Mm, Mm, Mm^Qhh, Mm^Qhh, Aa^Fpa, Ha^Fpa, Aa^Fpa, Gg, Gs^Fp, Gs^Fp, Aa^Fp, Gs^Fp, Aa^Fp, Gs^Fp
Mm, Mm, Mm, Ms, Ms, Aa^Fpa, Aa^Fpa, Aa^Fpa, Gs^Fp, Aa^Fpa, Aa^Fpa, Aa^Fpa, Gs^Fp, Aa^Fpa, Gs^Fp, Cfr, Hh, Mm, Mm, Gs^Qhhf, Hh^Qhh, Gs^Fp, Hh^Qhh, Hh^Qhh, Gs^Qhhf, Hh^Qhh, Ha^Qhh, Ha^Qhh, Ha^Qhh, Ms, Ms, Ms^Xm, Ms^Xm, Ms^Xm, Mm, Mm, Mm, Ha^Qhhf, Ha^Qhhf, Ha^Fpa, Aa, Gs^Fp, Gs^Fp, Gs^Fp, Gs^Vl, Gs^Fp, Aa^Fpa
Ww, Ww, Ww, Ai, Ai, Gs^Fp, Aa^Fpa, Gs^Fp, Hh, Gs^Fp, Gs^Fp, Gs^Fp, Gs^Fp, Gs^Fp, Gs^Fp, Gg, Cfr, 2 Kfr, Cfr, Hh, Hh, Hh^Qhh, Gs^Fp, Gs^Fp, Gs^Fp, Gs^Fp, Gs^Fp, Ha, Ha, Ha^Qhh, Ha^Qhh, Mm, Mm^Qhh, Ms^Xm, Ms^Xm, Mm, Mm, Mm, Hh^Qhh, Ha^Fpa, Aa, Aa, Aa^Fpa, Aa^Fpa, Aa^Fpa, Aa^Fpa, Aa^Fpa
Ai, Wo, Wo, Wo, Ai, Ai, Ai, Ai, Ai, Gs^Fp, Gs^Fp, Gs, Gs^Fp, Re, Re, Gs^Fp, Gs^Fp, Cfr, Hh^Fp, Hh, Hh, Gs^Fp, Gs^Fp, Gs^Fp, Gg^Efm, Gs^Fp, Gs^Fp, Gg^Fet, Gg^Vd, Hh, Ha, Mm^Qhh, Ha, Kfa^Qhh, Cfa^Dr, Ms^Xm, Mm, Mm, Mm^Qhh, Hh, Mm, Aa^Fpa, Aa^Fpa, Ha^Fpa, Ha^Fpa, Aa^Fpa, Aa^Fpa
Gs^Fp, Gs^Fp, Gs^Fp, Hh, Hh, Wo, Wo, Ww, Wo, Ww, Ww, Gs^Vh, Gs^Fp, Gs^Fp, Rb, Gs^Vh, Hh, Re, Gs^Fp, Gs^Fp, Hh, Gs^Fp, Gs^Fp, Gg^Efm, Gs^Fp, Gs^Fp, Gs^Fp, Gs^Fp, Gs^Fp, Gs^Fp, Gs^Fp, Ha^Dr, Ha, Cfa^Qhh, Mm^Qhh, Mm^Qhh, Mm^Qhh, Mm, Mm, Mm^Qhh, Hh^Qhh, Hh^Qhhf, Hh^Qhhf, Ha^Fpa, Hh^Qhhf, Ha^Fpa, Gs^Fp
Hh, Hh, Ha, Hh, Hh^Fp, Gg, Gg, Wo, Gs^Fp, Ww, Ww, Wwf, Wwf, Gs^Fp, Rb, Re, Rb, Rb, Gg, Gs^Fp, Gs^Fp, Gs^Fp, Gs^Vd, Gs, Gs^Fp, Gs^Fp, Gs^Fp, Gs^Fp, Gs^Fp, Gs^Fp, Gs^Fp, Gs^Fp, Gs^Fp, Ha, Ha, Mm, Ha^Qhh, Mm, Mm, Ha, Ha, Gs^Fp, Mm, Gs^Qhhf, Hh^Fet, Hh^Qhhf, Gs^Fp
Mm, Hh, Hh, Ha, Hh, Gg^Fp, Gs^Fp, Gs^Fp, Gs^Fp, Gs^Fp, Gs^Fp, Ww, Wwf, Wwf, Wwf, Gs^Fp, Gs^Fp, Gg^Fet, Gs^Fp, Gg, Gg, Gs^Fp, Gs^Fp, Gg, Gg^Efm, Gs^Efm, Gs^Fp, Gs^Fp, Gs^Fp, Gs, Gs^Fp, Gs^Fp, Gs^Fp, Gs^Fet, Gs^Fp, Hh, Hh, Ha^Qhh, Ha, Ha, Ha^Vd, Mm, Mm, Hh^Fp, Hh^Fp, Hh^Qhhf, Gs^Fp
Ha, Ha, Ha, Hh, Hh, Hh, Gs^Fp, Gs^Fp, Gs^Fp, Gg, Gg^Efm, Gg, Gg, Wwf, Wwf, Wwf, Ww, Gs^Fp, Gs^Fp, Gs^Fp, Gs^Fp, Gg, Gs^Fp, Gs^Fp, Gs^Fp, Gg^Efm, Gs^Fp, Gs^Fp, Gs, Gs, Gs, Gs^Fp, Gs^Fp, Gs^Fp, Gs^Fp, Hh, Gs^Fp, Hh^Qhh, Hh^Qhh, Mm, Mm, Mm, Mm, Mm, Hh^Fp, Hh^Qhhf, Gs^Qhhf
Ms^Xm, Hh, Mm, Ha, Ms, Ha, Ha, Gs^Fp, Gs^Fp, Gs^Fp, Gs^Fp, Gg^Efm, Rb, Rb, Gg, Wo, Ww, Ww, Gs^Fp, Gg^Fet, Gs^Fp, Gs^Fp, Gs^Fp, Gg^Efm, Gg^Efm, Gs^Fp, Gs^Fp, Gs^Fp, Gs^Fp, Gs^Fp, Gs^Fp, Gs^Fp, Gs^Fp, Gs^Fp, Gs^Fp, Gs^Fp, Gs^Fp, Hh, Hh^Qhh, Hh, Mm, Mm, Mm^Xm, Mm, Mm, Hh^Fp, Hh^Qhhf
Aa, Aa, Rb, Rb, Aa, Ha, Hh, Hh, Aa, Hh, Gs^Fp, Gg^Efm, Re, Re, Gg^Efm, Wo, Wo, Ww, Wo, Gs^Fp, Gs^Fp, Gs^Fp, Gg^Fet, Gs^Fp, Gs^Fp, Gs^Fp, Gs^Fp, Gs^Fp, Gs^Fp, Gs^Fp, Rr^Vd, Gg^Fet, Gs, Gs^Fp, Gs, Gs^Fp, Gs^Fp, Gs^Fp, Hh^Qhh, Hh, Mm, Mm^Xm, Mm, Mm^_mh, Mm, Hh^Fet, Gs^Qhhf
Mm^Qhh, Ha, Ha, Ha, Hh, Aa, Rb, Aa, Ce, Aa, Rb, Gg, Re, Gg, Gs^Efm, Gg, Gg^Efm, Ww, Ww, Wo, Ww, Gs^Fp, Gs^Fp, Gs^Fp, Gs^Fp, Gg^Efm, Re, Gs^Fp, Gs^Fp, Gs^Fp, Gg^Efm, Gs^Fp, Gs^Fp, Gs, Gs^Fp, Gs^Fp, Hh, Hh^Qhh, Mm, Mm, Mm, Mm, Mm^Xm, Mm, Mm, Mm, Hh^Qhhf
Hh^Qhh, Hh^Qhh, Hh^Qhh, Hh^Qhh, Hh^Qhh, Hh, Hh, Re, 1 Ke, Ce, Gs^Fp, Rb, Re, Gs^Efm, Gs, Gg^Efm, Gg, Gg^Efm, Wwf, Ww, Gs^Fp, Ww, Ww, Gs^Fp, Gs^Fp, Rb^Gvs, Rb^Gvs, Rb^Gvs, Rb^Gvs, Gg^Efm, Gs^Fp, Gs^Fp, Gs^Fp, Gs, Gs^Fp, Gs^Fp, Hh, Hh^Qhh, Mm, Mm, Mm, Mm, Mm, Mm^Xm, Mm^Xm, Hh^Fp, Hh^Qhhf
Mm^Qhh, Hh, Mm, Mm, Mm, Hh^Qhh, Hh, Ce, Ce, Gg, Hh, Gs^Fp, Gs^Fp, Rb, Rb, Re, Re, Rb, Rb, Wwf, Wwf, Ww, Wo, Ww, Ww, Gs^Vh, Re^Gvs, Re^Gvs, Re^Gvs, Rb^Gvs, Rb^Gvs, Gs^Fp, Gs^Fp, Gs^Fp, Gs^Fp, Hh^Fp, Hh^Qhh, Mm^Qhh, Mm, Mm, Mv, Mm^Xm, Mm, Mm, Mm, Mm, Hh^Qhhf
Ms^Qhh, Mm, Ms^Xm, Ms, Mm, Mm^Qhh, Mm^Qhh, Hh, Hh^Qhh, Hh^Qhh, Hh^Qhh, Hh, Hh^Qhh, Gg^Fp, Gg^Fp, Gg^Fp, Gg^Fp, Gs^Fp, Rb, Gg, Gg, Ww, Ww, Wo, Ww, Re, Re^Gvs, Re^Gvs, Re^Gvs, Re^Gvs, Re^Gvs, Gs^Fp, Gs^Fp, Gg, Hh^Fp, Hh^Qhh, Mm, Mm, Mm, Mm, Mm, Mm, Mm, Mm^Xm, Mm, Hh^Fp, Gs^Qhhf
Ms^Qhh, Ha, Ha, Ms^Xm, Ha, Mm, Mm^Qhh, Mm^Qhh, Mm^Qhh, Mm^Qhh, Mm, Hh^Qhh, Mm, Hh^Qhh, Hh^Qhh, Gg^Fp, Gs^Fp, Gs^Fp, Gs^Fp, Rb, Gg^Vh, Ww, Ww, Wo, Wo, Wwf, Wwf, Gs^Fp, Gs^Fp, Re^Gvs, Gs^Fp, Gg, Gg^Fet, Gs^Fp, Hh^Fp, Mm^Qhh, Mm^Qhh, Mm, Cte, Cfr, 3 Kte, Mm, Mm^Vd, Mm, Mm, Mm, Mm^Qhh
Mm^Qhh, Mm, Ha, Ha, Ha, Ha, Ha, Ha, Ha, Mm^_mh, Mm, Mm, Mm, Mm, Hh^Vhh, Hh^Qhh, Hh^Qhh, Gs^Fp, Hh^Qhh, Re, Re, Gs^Fp, Gs^Fp, Wo, Wo, Wo, Wo, Wwf, Ww, Wo, Wo, Gs^Fp, Rr^Vd, Gg, Gs^Fp, Hh, Hh^Qhh, Mm, Cfr, Ql, Cte, Mm, Mm, Mm, Mv, Mm, Mm^Qhh
Ms^Qhh, Mm^Qhh, Mm^Qhh, Ha, Ha, Hh, Hh, Hh, Hh, Mm, Hh, Mm, Mm, Mm, Mm, Mm, Mm, Hh^Qhh, Hh, Hh^Qhh, Gs^Qhhf, Rb, Rb, Gg, Rb, Ww, Gg, Ww, Ww, Wo, Wo, Ww, Ww, Gs^Fp, Gs^Fp, Gs^Fp, Hh, Mm^Qhh, Mm^Qhh, Cfr, Mm^Qhh, Mm^Qhh, Hh^Qhh, Hh^Qhhf, Hh^Qhhf, Mm^Qhh, Hh
Ms^Qhh, Mm, Mm, Ha^Qhh, Ha^Qhh, Ha, Ha, Hh, Hh, Hh, Hh, Hh, Hh, Mm, Gs^Fp, Mm, Gs^Fp, Mm, Mm, Hh, Hh^Qhh, Gs^Fp, Gs^Fp, Gs^Fp, Gs^Fp, Gg, Rb, Gg, Re, Ww, Gg, Ww, Ww, Wo, Wo, Ww, Ww, Hh, Ww, Mm^Qhh, Ww, Hh, Ww, Hh^Fp, Ww, Hh, Gs^Fp
Ms^Qhh, Ms^Xm, Mm, Ha, Ha, Ha^Qhh, Ha, Ha, Aa^Fpa, Hh, Hh, Hh, Hh, Hh, Gs^Fp, Gs^Fp, Gg^Efm, Gs^Fp, Gg^Efm, Mm, Hh, Hh^Qhh, Hh^Vhh, Gs^Fp, Gg, Gg, Hh, Re, Gg, Rb, Re, Ww, Re, Wo, Ww, Wo, Ww, Ww, Wo, Wo, Ww, Ww, Ww, Wo, Wo, Ww, Wo
Ms^Qhh, Ms^Xm, Ms^Xm, Mm, Mm, Ha^Qhh, Ha^Qhh, Hh, Aa^Fpa, Aa^Fpa, Gs^Fp, Gs^Fp, Gs^Fp, Gs^Fp, Gs^Fp, Gs^Fp, Gs^Fp, Gg^Efm, Gs^Fp, Hh, Hh, Hh^Qhh, Mm^Qhh, Hh^Qhh, Hh^Qhh, Gs^Fp, Mm^Qhh, Hh^Qhh, Hh^Qhh, Hh, Mm, Re, Hh, Gg, Gg, Re, Rb, Ww, Hh, Wwf, Hh, Hh, Hh, Wwf, Wwf, Wo, Wo
Mm^Qhh, Mm, Mm, Mm, Mm, Ms, Ha^Qhh, Hh, Aa^Fpa, Aa^Fpa, Gg^Efm, Gs^Fp, Gg^Fet, Gs^Fp, Gs^Fp, Gs^Fp, Gs^Fp, Gs^Fp, Re^Gvs, Re^Gvs, Gs^Fp, Cfr^Qhh, Kfr^Qhh, Mm, Mm^_mhh, Hh^Qhh, Hh, Mm, Mm, Mm^Qhh, Mm^Qhh, Hh^Vd, Hh^Qhh, Hh^Qhh, Hh^Qhh, Hh^Qhh, Hh^Qhh, Rb, Re, Hh, Gg, Hh, Hh, Hh, Hh, Wwf, Ww
Mm^Qhh, Mm, Mm, Mm, Mm, Ms, Mm, Hh^Qhh, Hh^Qhh, Aa^Fpa, Hh^Qhh, Gs^Fp, Gs^Ve, Gs^Fp, Gs^Fp, Re^Gvs, Re^Gvs, Re^Gvs, Re^Gvs, Re^Gvs, Gs^Fp, Gs^Fp, Cfr^Qhh, Mm^Qhh, Mm^Qhh, Mm^Qhh, Hh^Qhh, Hh^_mhh, Hh, Mm, Hh^Qhh, Mm^Qhh, Mm^Qhh, Hh^_mhh, Mm, Hh, Mm, Hh^Qhh, Hh^Vd, Re, Gs^Fp, Rb, Rb, Hh, Re, Rb, Rb
Hh^Qhh, Hh, Hh, Mm, Mm, Mm^Xm, Mm, Mm, Mm, Hh^Qhh, Hh, Hh^Qhh, Gs^Fp, Gg^Efm, Gs^Fp, Gs^Fp, Gs^Fp, Gs^Fp, Gs^Fp, Gs^Vh, Gs^Fp, Gs^Fp, Hh, Hh, Hh, Hh^Dr, Ms^Qhh, Hh, Mm^Qhh, Hh^Qhh, Aa^Fpa, Hh^Qhh, Aa^Fpa, Mm^Qhh, Mm^Qhh, Mm^Qhh, Mm^Qhh, Mm^Qhh, Hh, Hh, Gs^Fp, Gs^Fp, Gs^Fp, Re, Gs^Fp, Gs^Fp, Gs^Fp
Hh^Qhh, Mm, Mm, Hh^_mhh, Mm^Xm, Mm, Mm, Mm, Hh^Fp, Mm, Hh, Hh^Qhh, Mm^Qhh, Gs^Fp, Gs^Fp, Gs^Fp, Gs^Fp, Gs^Fp, Gs^Fp, Gs^Fp, Gg^Fet, Gs^Fp, Hh, Gs^Fp, Gs^Fp, Aa^Fpa, Aa^Fpa, Ms^Qhh, Ms, Aa^Fpa, Ms, Aa^Fpa, Aa^Fpa, Gs^Fp, Gg, Gs^Fp, Gs^Fp, Gs^Fp, Hh, Hh, Hh, Gs^Fp, Hh, Gs^Fp, Gg, Gg, Gg
Gs^Qhhf, Hh, Hh^Fp, Mm, Mm, Ms, Ms, Mm^Xm, Mm, Hh^Fp, Gs^Fp, Gs^Fp, Mm, Mm^Qhh, Gs^Fp, Gs^Fp, Gg^Fet, Gs^Fp, Hh^Fp, Gs^Fp, Gs^Fp, Gs^Fp, Hh, Hh, Gg^Efm, Gg^Efm, Aa^Fpa, Ms, Aa^Fpa, Ms, Mm, Ms, Hh, Gg, Gs^Fp, Gs^Fp, Gs^Fp, Gs^Fp, Gs^Fp, Gs^Fp, Aa^Fpa, Hh, Gs^Fp, Hh, Gs^Fp, Gs^Fp, Gs^Fp
Hh^Qhux, Gs^Qhhf, Gs^Qhhf, Gs^Qhhf, Gs^Qhhf, Mm^Xm, Ms, Ms, Ms, Gs^Fp, Mm, Aa^Fpa, Ms, Ms^Qhh, Mm^Qhh, Gs^Fp, Gs^Fp, Hh^Fp, Hh, Hh, Ha, Hh, Hh, Gs^Fp, Gs^Fp, Gg^Efm, Hh^Fp, Gs^Fp, Gs^Fp, Gg^Efm, Gs^Fp, Hh, Hh, Ha, Ha, Gs^Fp, Aa^Fma, Gs^Fp, Gs^Fp, Gs^Fp, Aa^Fpa, Aa^Fpa, Aa^Fpa, Gs^Vd, Gs^Fp, Aa^Fpa, Gs^Fp
Mm^Qhux, Hh^Qhux, Hh^Qhux, Gs^Qhux, Gs^Qhux, Mm^Qhh, Mm^Qhh, Ms, Ms, Hh, Hh, Mm, Mm^Qhh, Ms^Qhh, Mm^Qhh, Mm^Qhh, Hh^Qhux, Hh^Qhux, Ms^Qhux, Hh^Qhux, Hh^Qhux, Ha^Qhux, Mm^Qhux, Hh, Hh^Qhux, Hh^Fp, Gs^Fp, Mm, Hh, Gs^Fp, Ha, Hh, Hh, Gs^Fp, Gs^Fp, Ha, Ha, Gs^Fp, Hh, Gs^Fp, Gs^Fp, Aa^Fpa, Aa^Fpa, Gg, Gg, Aa^Fpa, Aa^Fpa
Ms^Qhux, Mm, Mm, Mm, Hh^Qhux, Hh^Qhux, Hh^Qhux, Mm^Qhh, Mm^Qhh, Mm^Qhh, Mm^Qhh, Mm^Qhh, Hh^Qhux, Mm^Qhh, Ms^Qhux, Hh^Qhux, Mm, Mm, Mm, Hh^Vhh, Ms, Ms, Ms, Mm^Qhux, Ms, Ha^Qhux, Ha^Qhux, Hh^Qhux, Hh^Qhux, Ha, Hh, Gs^Fp, Hh, Hh^Fp, Hh, Gs^Fp, Gs^Fp, Hh, Gs^Fp, Hh, Hh^Qhux, Hh^Fp, Hh^Fp, Aa^Fpa, Gg, Aa^Fpa, Aa^Fpa
Ms^Qhux, Ms^Xm, Mm, Mm, Hh^Qhux, Ms, Ms, Ms^Qhux, Ms^Qhux, Hh^Qhux, Gs^Qhux, Gs^Qhux, Ms, Ms, Ms, Ms, Ms, Mm, Mm, Mm, Mm, Ms, Mm, Ms, Mm, Ms, Hh^Qhux, Mm^_ml, Hh^Qhux, Hh^Qhux, Hh^Qhux, Gs^Fp, Gs^Fp, Hh, Gs^Fp, Ha, Ha^Qhux, Hh, Hh^Qhux, Ha^Qhux, Mm, Gs^Qhux, Gs^Qhux, Hh^Qhux, Hh^Qhux, Hh^Fp, Gs^Fp
Ms^Qhux, Ms^Xm, Ms, Ms, Ms, Ms^Xm, Ms^Xm, Ms^Xm, Gs^Fp, Ms^Qhux, Ms^Xm, Ms, Ms, Ms, Mm, Ms, Gs^Fp, Mm, Gs^Fp, Mm, Mm, Mm, Ms, Mm, Mm, Mm, Hh^Qhux, Hh^Qhux, Mm, Hh^Vhh, Hh^Qhux, Ms^Qhux, Ms^Qhux, Gs^Fp, Mm^Qhux, Mm^Qhux, Mm, Ha^Qhux, Ms, Ms, Mm, Mm, Mm, Ms, Ms, Hh^Qhux, Hh^Qhux
Ms^Qhux, Ms^Xm, Ms^Xm, Ms, Ms^Xm, Ms^Xm, Mm^_ml, Mm, Ms^Xm, Gg^Fet, Mm, Ms^Xm, Ms^Xm, Ms, Ms, Ms^Xm, Ms^Xm, Gg^Fet, Ms^Fp, Gs^Fp, Gs^Qhux, Gs^Fp, Ms^Xm, Ms, Ms, Hh^Qhux, Ms^Xm, Mm, Ms, Ms, Ms^_ml, Ms^Xm, Ms^Xm, Mm^Qhux, Ms^_ml, Mm, Mm, Gs^Fp, Mm, Ms, Ms, Ms^Xm, Ms, Ms^Xm, Ms, Hh^Qhux, Hh^Qhux
Ms^Qhux, Ms^Qhux, Ms^Qhux, Ms^Qhux, Ms^Qhux, Ms^Qhux, Ms^Qhux, Ms^Qhux, Gs^Qhux, Gs^Qhux, Gs^Qhux, Gs^Qhux, Gs^Qhux, Mm^Qhux, Gs^Qhux, Ms^Qhux, Ms^Qhux, Ms^Qhux, Ms^Qhux, Ms^Qhux, Gs^Qhux, Gs^Qhux, Gs^Qhux, Ms^Qhux, Gs^Qhux, Ms^Qhux, Gs^Qhux, Ms^Qhux, Ms^Qhux, Ms^Qhux, Gs^Qhux, Ms^Qhux, Ms^Qhux, Ms^Qhux, Ms^Qhux, Ms^Qhux, Gs^Qhux, Mm^Qhux, Gs^Qhux, Mm^Qhux, Gs^Qhux, Ms^Qhux, Ms^Qhux, Ms^Qhux, Ms^Qhux, Ms^Qhux, Gs^Qhux
