Hh, Hh, Hh, Hh, Hh, Ms^Xm, Hh, Mm^Xm, Hh, Mm^Xm, Mm, Mm, Mm, Mm, Mm, Mm, Mm, Mm, Mm, Mm, Mm, Mm, Mm, Mm, Hh, Hh, Hh, Gs^Fp, Gs^Fp, Gs^Fp, Gs^Fp, Gs^Fp, Gs^Fp, Gs^Fp, Gs^Fp, Gs^Fp, Gs^Fp, Gs^Fp, Gs^Fp, Gs^Fp, Gs^Fp, Gs^Fp, Gs^Fp, Gs^Fp, Gg, Gs^Fp, Gs^Fp
Ms^Xm, Mm, Mm, Hh, Hh, Mm, Hh, Hh, Hh, Hh, Hh, Hh, Hh, Mm, Mm, Mm, Hh, Mm, Mm, Mm, Mm, Mm, Mm, Mm, Mm, Hh, Hh, Gs^Fp, Hh, Gs^Fp, Hh, Gs^Fp, Gs^Fp, Gs^Fp, Gs^Fp, Gs^Fp, Gs^Fp, Gs^Fp, Gs^Fp, Gs^Fp, Gg, Gs^Fp, Gs^Fp, Gs^Fp, Gs^Fp, Gs^Fp, Gs^Fp
Ms^Xm, Mm, Ms^Xm, Gs^Fp, Gs^Fp, Gs^Fp, Gs^Fp, Gs^Fp, Gs^Fp, Gs^Fp, Gs^Fp, Hh, Hh, Hh, Hh, Mm, Hh, Hh, Hh, Mm, Mm, Mm, Mm, Mm, Mm, Mm, Mm, Hh, Hh, Gs^Fp, Mm, Gs^Fp, Gs^Fp, Gs^Fp, Gs^Fp, Gs^Fp, Gs^Fp, Gs^Fp, Gs^Fp, Gs^Fp, Gs^Fp, Gs^Fp, Gs^Fp, Gs^Fp, Gg^Fet, Gs^Fp, Gs^Fp
Ms^Xm, Mm, Hh, Gs^Fp, Gs^Fp, Gs^Fp, Gs^Fp, Gs^Fp, Gs^Fp, Hh, Aa^Fpa, Hh, Hh, Hh, Hh, Hh, Gs^Fp, Hh, Hh, Hh, Mm, Mm, Mm, Mm, Mm, Ms^Xm, Ms^Xm, Mm, Ms^Xm, Mm, Mm, Mm, Mm, Gs^Fp, Gs^Fp, Gs^Fp, Gs^Fp, Gg^Fet, Gg, Gg, Gs^Vl, Gs^Fp, Gs^Fp, Gs^Fp, Gs^Fp, Gs^Fp, Gs^Fp
Ms^Xm, Ms^Xm, Mm, Hh, Ms, Hh, Mm, Hh^Vl, Mm, Hh, Aa^Fpa, Gs^Fp, Hh, Hh, Gs^Fp, Gs^Fp, Gs^Fp, Hh, Hh, Hh^Vl, Hh, Hh, Hh, Mm, Mm, Ms^Xm, Ms, Mm, Mm, Mm, Ms^Xm, Mm, Mm, Mm, Mm, Gs^Fp, Gs^Fp, Gg, Gs^Fp, Gg, Gs^Fp, Gs^Fp, Gs^Fp, Gs^Fp, Gs^Fp, Gs^Fp, Gs^Fp
Mm, Ms^Xm, Ms, Ms^Xm, Ms, Ms, Ms, Mm, Aa^Fpa, Aa^Fpa, Aa^Fpa, Aa^Fpa, Gs^Fp, Hh, Gs^Fp, Gg, Gs^Fp, Hh, Hh, Hh, Gs^Fp, Hh, Hh, Ha, Hh, Mm, Mm, Ms, Ms, Ms^Xm, Ms^Xm, Ms^Xm, Ms^Xm, Mm, Mm, Mm, Mm, Gs^Fp, Gs^Fp, Gs^Fp, Gg, Gs^Fp, Gs^Fp, Gs^Fp, Gs^Fp, Gs^Fp, Gs^Fp
Mm, Mm, Mm, Ms, Ms, Aa^Fpa, Aa^Fpa, Aa^Fpa, Gs^Fp, Aa^Fpa, Aa^Fpa, Aa^Fpa, Gs^Fp, Aa^Fpa, Gs^Fp, Ce, Hh, Hh, Hh, Gs^Fp, Hh, Gs^Fp, Hh, Hh, Gs^Fp, Hh, Ha, Ha, Ha, Ms, Ms, Ms^Xm, Ms^Xm, Ms^Xm, Mm, Mm, Mm, Gs^Fp, Gs^Fp, Gs^Fp, Gg, Gs^Fp, Gs^Fp, Gs^Fp, Gs^Vl, Gs^Fp, Gs^Fp
Ww, Ww, Ww, Ww, Ww, Gs^Fp, Aa^Fpa, Gs^Fp, Hh, Gs^Fp, Gs^Fp, Gs^Fp, Gs^Fp, Gs^Fp, Gs^Fp, Gg, Ce, Ke, Ce, Hh, Hh, Hh, Gs^Fp, Gs^Fp, Gs^Fp, Gs^Fp, Gs^Fp, Ha, Ha, Ha, Ha, Mm, Mm, Ms^Xm, Ms^Xm, Mm, Mm, Mm, Hh, Gs^Fp, Gg, Gg, Gs^Fp, Gs^Fp, Gs^Fp, Gs^Fp, Gs^Fp
Wo, Wo, Wo, Wo, Wo, Ww, Ww, Ww, Ww, Gs^Fp, Gs^Fp, Gs, Gs^Fp, Re, Re, Gs^Fp, Gs^Fp, Ce, Hh^Fp, Hh, Hh, Gs^Fp, Gs^Fp, Gs^Fp, Gg^Efm, Gs^Fp, Gs^Fp, Gg^Fet, Gg^Vd, Hh, Ha, Mm, Ha, Mm, Mm, Ms^Xm, Mm, Mm, Mm, Hh, Mm, Gs^Fp, Gs^Fp, Gs^Fp, Gs^Fp, Gs^Fp, Gs^Fp
Gs^Fp, Gs^Fp, Gs^Fp, Hh, Hh, Wo, Wo, Ww, Wo, Ww, Ww, Gs^Vh, Gs^Fp, Gs^Fp, Rb, Gs^Vh, Hh, Re, Gs^Fp, Gs^Fp, Hh, Gs^Fp, Gs^Fp, Gg^Efm, Gs^Fp, Gs^Fp, Gs^Fp, Gs^Fp, Gs^Fp, Gs^Fp, Gs^Fp, Ha, Ha, Mm, Mm, Mm, Mm, Mm, Mm, Mm, Hh, Gs^Fp, Gs^Fp, Gs^Fp, Gs^Fp, Gs^Fp, Gs^Fp
Hh, Hh, Ha, Hh, Hh^Fp, Gg, Gg, Wo, Gs^Fp, Ww, Ww, Wwf, Wwf, Gs^Fp, Rb, Re, Rb, Rb, Gg, Gs^Fp, Gs^Fp, Gs^Fp, Gs^Vd, Gg, Gs^Fp, Gs^Fp, Gs^Fp, Gs^Fp, Gs^Fp, Gs^Fp, Gs^Fp, Gs^Fp, Gs^Fp, Ha, Ha, Mm, Ha, Mm, Mm, Ha, Ha, Gs^Fp, Mm, Gs^Fp, Gg^Fet, Gs^Fp, Gs^Fp
Mm, Hh, Hh, Ha, Hh, Gg^Fp, Gs^Fp, Gs^Fp, Gs^Fp, Gs^Fp, Gs^Fp, Ww, Wwf, Wwf, Wwf, Gs^Fp, Gs^Fp, Gg^Fet, Gs^Fp, Gg, Gg, Gs^Fp, Gs^Fp, Gg, Gg^Efm, Gg^Efm, Gs^Fp, Gs^Fp, Gs^Fp, Gg, Gs^Fp, Gs^Fp, Gs^Fp, Gg^Fet, Gs^Fp, Hh, Hh, Ha, Ha, Ha, Ha, Mm, Mm, Gs^Fp, Gs^Fp, Gs^Fp, Gs^Fp
Ha, Ha, Ha, Hh, Hh, Hh, Gs^Fp, Gs^Fp, Gs^Fp, Gg, Gg^Efm, Gg, Gg, Wwf, Wwf, Wwf, Ww, Gs^Fp, Gs^Fp, Gs^Fp, Gs^Fp, Gg, Gs^Fp, Gs^Fp, Gs^Fp, Gg^Efm, Gs^Fp, Gs^Fp, Gg, Gg, Gg, Gs^Fp, Gs^Fp, Gs^Fp, Gs^Fp, Hh, Gs^Fp, Hh, Hh, Mm, Mm, Mm, Mm, Mm, Gs^Fp, Gs^Fp, Gs^Fp
Ms^Xm, Hh, Mm, Ha, Ms, Ha, Ha, Gs^Fp, Gs^Fp, Gs^Fp, Gs^Fp, Gg^Efm, Rb, Rb, Gg, Wo, Ww, Ww, Gs^Fp, Gg^Fet, Gs^Fp, Gs^Fp, Gs^Fp, Gg^Efm, Gg^Efm, Gs^Fp, Gs^Fp, Gs^Fp, Gs^Fp, Gs^Fp, Gs^Fp, Gs^Fp, Gs^Fp, Gs^Fp, Gs^Fp, Gs^Fp, Gs^Fp, Hh, Hh, Hh, Mm, Mm, Mm, Mm, Mm, Gs^Fp, Gs^Fp
Aa, Aa, Rb, Rb, Aa, Ha, Hh, Hh, Aa, Hh, Gs^Fp, Gg^Efm, Re, 2 Re, Gg^Efm, Wo, Wo, Ww, Wo, Gs^Fp, Gs^Fp, Gs^Fp, Gg^Fet, Gs^Fp, Gs^Fp, Gs^Fp, Gs^Fp, Gs^Fp, Gs^Fp, Gs^Fp, Rr^Vd, Gg^Fet, Gg, Gs^Fp, Re^Gvs, Gs^Fp, Gs^Fp, Gs^Fp, Hh, Hh, Mm, Mm, Mm, Mm, Mm, Gg^Fet, Gs^Fp
Mm, Ha, Ha, Ha, Hh, Aa, Rb, Aa, Ce, Aa, Rb, Gg, Re, Gg, Gg^Efm, Gg, Gg^Efm, Ww, Ww, Wo, Ww, Gs^Fp, Gs^Fp, Gs^Fp, Gs^Fp, Gg^Efm, Re^Gvs, Gs^Fp, Gs^Fp, Gs^Fp, Gg^Efm, Gs^Fp, Gs^Fp, Re^Gvs, Gs^Fp, Gs^Fp, Hh, Hh, Mm, Mm, Mm, Mm, Mm, Mm, Mm, Mm, Gs^Fp
Hh, Hh, Hh, Hh, Hh, Hh, Hh, Re, 1 Ke, Ce, Gs^Fp, Rb, Re, Gg^Efm, Gg, Gg^Efm, Gg, Gg^Efm, Wwf, Ww, Gs^Fp, Ww, Ww, Gs^Fp, Gs^Fp, Gg, Re^Gvs, Re^Gvs, Gs^Fp, Gg^Efm, Gs^Fp, Gs^Fp, Gs^Fp, Re^Gvs, Gs^Fp, Gs^Fp, Hh, Mm, Mm, Mm, Mm, Mm, Mm, Mm, Mm, Gs^Fp, Gs^Fp
Mm, Hh, Mm, Mm, Mm, Hh, Hh, Ce, Ce, Gg, Hh, Gs^Fp, Gs^Fp, Rb, Rb, Re, Re, Rb, Rb, Wwf, Wwf, Ww, Wo, Ww, Ww, Gs^Vh, Re^Gvs, Re^Gvs, Gs^Fp, Gs^Fp, Gs^Fp, Gs^Fp, Gs^Fp, Gs^Fp, Gs^Fp, Gs^Fp, Hh, Mm, Mm, Mm, Mm, Mm, Mm, Mm, Mm, Gs^Fp, Gs^Fp
Mm, Mm, Ms^Xm, Mm, Mm, Mm, Mm, Hh, Hh, Hh, Hh, Hh, Hh, Gs^Fp, Gs^Fp, Gs^Fp, Gs^Fp, Gs^Fp, Rb, Gg, Gg, Ww, Ww, Wo, Ww, Gg, Re^Gvs, Gs^Fp, Gs^Fp, Gs^Fp, Gg, Gs^Fp, Gs^Fp, Gg, Gs^Fp, Hh, Hh, Mm, Mm, Mm, Mm, Mm, Mm, Mm, Mm, Gs^Fp, Gs^Fp
Mm, Ha, Ha, Ms^Xm, Ha, Mm, Mm, Mm, Mm, Mm, Mm, Hh, Mm, Hh, Hh, Gs^Fp, Gs^Fp, Gs^Fp, Gs^Fp, Rb, Gg^Vh, Ww, Ww, Wo, Wo, Wwf, Wwf, Gs^Fp, Gs^Fp, Gs^Fp, Gs^Fp, Gg, Gg^Fet, Gs^Fp, Gs^Fp, Hh, Hh, Mm, Cte, Cte, Cte, Mm, Mm, Mm, Mm, Mm, Mm
Mm, Mm, Ha, Ha, Hh, Ha, Ha, Ha, Ha, Mm, Mm, Mm, Mm, Mm, Hh^Vhh, Hh, Hh, Gs^Fp, Hh, Re, Re, Gs^Fp, Gs^Fp, Wo, Wo, Wo, Wo, Wwf, Ww, Wo, Wo, Gs^Fp, Rr^Vd, Gg, Gs^Fp, Hh, Hh, Mm, Cte, 3 Kte, Cte, Cte, Mm, Mm, Mm, Mm, Mm
Ms^Xm, Mm, Mm, Ha, Ha, Hh, Hh, Hh, Hh, Mm, Hh, Mm, Mm, Mm, Mm, Mm, Mm, Hh, Hh, Hh, Gs^Fp, Rb, Rb, Gg, Rb, Ww, Gg, Ww, Ww, Wo, Wo, Ww, Ww, Gs^Fp, Gs^Fp, Gs^Fp, Hh, Mm, Mm, Cte, Mm, Mm, Hh, Hh, Hh, Mm^Vd, Hh
Ms^Xm, Mm, Mm, Ha, Ha, Ha, Ha, Hh, Hh, Hh, Hh, Hh, Hh, Mm, Gs^Fp, Mm, Gs^Fp, Mm, Mm, Hh, Hh, Gs^Fp, Gs^Fp, Gs^Fp, Gs^Fp, Gg, Rb, Gg, Re, Ww, Gg, Ww, Ww, Wo, Wo, Ww, Ww, Hh, Ww, Mm, Ww, Hh, Ww, Hh, Ww, Hh, Gs^Fp
Mm, Ms^Xm, Mm, Ha, Ha, Ha, Ha, Ha, Aa^Fpa, Hh, Hh, Hh, Hh, Hh, Gs^Fp, Gs^Fp, Gg^Efm, Gs^Fp, Gg^Efm, Mm, Hh, Hh, Hh^Vhh, Gs^Fp, Gg, Gg, Hh, Re, Gg, Rb, Re, Ww, Re, Wo, Ww, Wo, Ww, Ww, Wo, Wo, Ww, Ww, Ww, Wo, Wo, Ww, Wo
Mm, Ms^Xm, Ms^Xm, Mm, Mm, Ha, Ha, Hh, Aa^Fpa, Aa^Fpa, Gs^Fp, Gs^Fp, Gs^Fp, Gs^Fp, Gs^Fp, Gs^Fp, Gs^Fp, Gg^Efm, Gs^Fp, Hh, Hh, Hh, Mm, Hh, Hh, Gs^Fp, Mm, Hh, Hh, Hh, Mm, Re, Hh, Gg, Gg, Re, Rb, Ww, Hh, Wwf, Hh, Hh, Hh, Wwf, Wwf, Wo, Wo
Mm, Mm, Mm, Mm, Mm, Mm, Ha, Hh, Aa^Fpa, Aa^Fpa, Gg^Efm, Gs^Fp, Gg^Fet, Gs^Fp, Gs^Fp, Gs^Fp, Gs^Fp, Gs^Fp, Re^Gvs, Re^Gvs, Gs^Fp, Hh, Hh, Mm, Mm, Hh, Hh, Mm, Mm, Mm, Mm, Hh^Vd, Hh, Hh, Hh, Hh, Hh, Rb, Re, Hh, Gg, Hh, Hh, Hh, Hh, Wwf, Ww
Mm, Mm, Mm, Mm, Mm, Mm, Mm, Hh, Hh, Aa^Fpa, Hh, Gs^Fp, Gs^Ve, Gs^Fp, Gs^Fp, Re^Gvs, Re^Gvs, Re^Gvs, Re^Gvs, Re^Gvs, Gs^Fp, Gs^Fp, Hh, Mm, Mm, Mm, Hh, Hh, Hh, Mm, Gs^Fp, Mm, Mm, Hh, Mm, Hh, Mm, Hh, Hh^Vd, Re, Gs^Fp, Rb, Rb, Hh, Re, Rb, Rb
Hh, Hh, Hh, Mm, Mm, Mm, Mm, Mm, Mm, Hh, Hh, Hh, Gs^Fp, Gg^Efm, Gs^Fp, Gs^Fp, Gs^Fp, Gs^Fp, Gs^Fp, Gs^Vh, Gs^Fp, Gs^Fp, Hh, Hh, Hh, Hh, Ms, Hh, Mm, Gs^Fp, Aa^Fpa, Gs^Fp, Aa^Fpa, Mm, Mm, Mm, Mm, Mm, Hh, Hh, Gs^Fp, Gs^Fp, Gs^Fp, Re, Gs^Fp, Gs^Fp, Gs^Fp
Hh, Mm, Mm, Hh, Mm, Mm, Mm, Mm, Gs^Fp, Mm, Hh, Hh, Mm, Gs^Fp, Gs^Fp, Gs^Fp, Gs^Fp, Gs^Fp, Gs^Fp, Gs^Fp, Gg^Fet, Gs^Fp, Hh, Gs^Fp, Gs^Fp, Gs^Fp, Gs^Fp, Ms, Ms, Aa^Fpa, Ms, Aa^Fpa, Aa^Fpa, Gs^Fp, Gg, Gs^Fp, Gs^Fp, Gs^Fp, Hh, Hh, Hh, Gs^Fp, Hh, Gs^Fp, Gg, Gg, Gg
Gs^Fp, Hh, Hh, Mm, Mm, Ms, Ms, Mm, Mm, Gs^Fp, Gs^Fp, Gs^Fp, Mm, Mm, Gs^Fp, Gs^Fp, Gg^Fet, Gs^Fp, Gs^Fp, Gs^Fp, Gs^Fp, Gs^Fp, Hh, Hh, Gg^Efm, Gg^Efm, Aa^Fpa, Mm, Aa^Fpa, Ms, Mm, Ms, Hh, Gg, Gs^Fp, Gs^Fp, Gs^Fp, Gs^Fp, Gs^Fp, Gs^Fp, Aa^Fpa, Hh, Gs^Fp, Hh, Gs^Fp, Gs^Fp, Gs^Fp
Hh, Gs^Fp, Gs^Fp, Gs^Fp, Gs^Fp, Mm, Ms, Ms, Ms, Gs^Fp, Mm, Gs^Fp, Ms, Ms, Mm, Gs^Fp, Gs^Fp, Gs^Fp, Hh, Hh, Ha, Hh, Hh, Gs^Fp, Gs^Fp, Gg^Efm, Gs^Fp, Gs^Fp, Gs^Fp, Gg^Efm, Gs^Fp, Hh, Hh, Ha, Ha, Gs^Fp, Aa^Fma, Gs^Fp, Gs^Fp, Gs^Fp, Aa^Fpa, Aa^Fpa, Aa^Fpa, Gs^Vd, Gs^Fp, Aa^Fpa, Gs^Fp
Mm, Hh, Hh, Gs^Fp, Gs^Fp, Mm, Mm, Ms, Ms, Hh, Hh, Mm, Mm, Ms, Mm, Mm, Gs^Fp, Gg^Efm, Ms, Hh, Hh, Ha, Mm, Hh, Hh, Gs^Fp, Gs^Fp, Mm, Hh, Gs^Fp, Ha, Hh, Hh, Gs^Fp, Gs^Fp, Ha, Ha, Gs^Fp, Hh, Gs^Fp, Gs^Fp, Aa^Fpa, Aa^Fpa, Gg, Gg, Aa^Fpa, Aa^Fpa
Ms^Xm, Mm, Mm, Mm, Hh, Hh, Hh, Mm, Mm, Mm, Mm, Mm, Hh, Hh, Ms, Mm, Mm, Mm, Mm^Vhh, Ms, Ms, Ms, Ms, Mm, Ms, Ha, Ha, Mm, Mm, Ha, Hh, Gs^Fp, Hh, Hh^Fp, Hh, Gs^Fp, Gs^Fp, Hh, Gs^Fp, Hh, Hh, Hh^Fp, Hh^Fp, Aa^Fpa, Gg, Aa^Fpa, Aa^Fpa
Ms^Xm, Ms^Xm, Mm, Mm, Hh, Ms, Ms, Ms, Ms^Xm, Gs^Fp, Gs^Fp, Gs^Fp, Ms, Ms, Ms, Ms, Ms, Mm, Mm, Mm, Mm, Ms, Mm, Ms, Mm, Ms, Hh, Hh, Hh^Fp, Mm, Mm, Gs^Fp, Gs^Fp, Hh, Gs^Fp, Ha, Ha, Hh, Hh, Ha, Mm, Gs^Fp, Gs^Fp, Hh, Hh, Hh^Fp, Gs^Fp
Ms^Xm, Ms^Xm, Ms, Ms, Ms, Ms, Ms, Ms, Gs^Fp, Ms^Xm, Ms^Xm, Ms, Ms, Ms, Mm, Ms, Gs^Fp, Mm, Gs^Fp, Mm, Mm, Mm, Ms, Mm, Mm, Mm, Hh, Hh^Fp, Mm, Hh^Vhh, Hh, Ms, Ms, Gs^Fp, Mm, Mm, Mm, Ha, Ms, Ms, Mm, Mm, Mm, Ms, Ms, Hh, Hh
Ms^Xm, Ms^Xm, Ms^Xm, Ms, Ms^Xm, Ms, Mm, Mm, Ms^Xm, Gg^Fet, Mm, Ms^Xm, Ms^Xm, Ms, Ms, Ms^Xm, Ms^Xm, Gg^Fet, Ms^Fp, Gs^Fp, Gg, Gs^Fp, Ms^Xm, Ms, Ms, Hh, Ms^Xm, Mm, Ms, Ms, Ms, Ms^Xm, Ms^Xm, Mm, Ms^Xm, Mm, Mm, Gs^Fp, Mm, Ms, Ms, Ms^Xm, Ms, Ms^Xm, Ms, Hh^Fp, Hh^Fp
Ms^Xm, Ms^Xm, Ms^Xm, Ms^Xm, Ms^Xm, Ms^Xm, Ms^Xm, Ms^Xm, Gs^Fp, Gs^Fp, Gs^Fp, Gs^Fp, Gs^Fp, Mm, Gs^Fp, Ms, Ms, Ms, Ms^Xm, Ms, Gs^Fp, Gs^Fp, Gs^Fp, Ms^Xm, Gs^Fp, Ms^Xm, Gs^Fp, Ms^Xm, Ms^Xm, Ms, Gs^Fp, Ms, Ms, Ms^Xm, Ms^Xm, Ms^Xm, Gs^Fp, Mm, Gs^Fp, Mm, Gs^Fp, Ms, Ms^Xm, Ms^Xm, Ms, Ms, Gs^Fp
