Hh^Qhh, Gg^Qhh, Mm^Qhh, Mm^Qhh, Mm^Qhh, Gg^Qhh, Mm^Qhh, Mm^Qhh, Mm^Qhh, Gg^Qhh, Gg^Qhhf, Gg^Fp, Gg^Qhhf, Gg^Qhh, Ds, Ds, Ds^Esd, Ww, Wo, Ww, Ww, Ww, Gg, Gg, Gg, Gg^Em, Hh, Hh, Gg, Gg, Hh, Hh, Gg^Em
Mm^Qhh, Mm, Hh, Mm, Mm, Mm^Xm, Mm^Xm, Mm^Xm, Hh^Fp, Hh^_mh, Gs^Qhh, Gg^Qhhf, Ww, Ds, Ww, Ww, Wwf, Ww, Wwf, Ww, Ds, Ww, Ww, Gg, Gg, Hh, Hh, Hh^Es, Hh, Hh, Gg, Hh^Es, Gg
Hh^Qhh, Hh, Hh, Hh, Hh, Mm^Xm, Mm, Mm, Gs^Qhhf, Gs^Qhh, Wo, Wo, Wo, Wo, Ww, Wwf, Wwf, Wwf, Gs^Fms, Gs^Fp, Gs^Fp, Ww, Ww, Ww, Hh, Hh, Hh, Hh, Gg, Gg, Gg, Gg, Gg^Efm
Mm^Qhh, Hh, Mm^Xm, Hh, Gs^Fp, Hh^Fp, Hh^Fp, Hh^Fp, Gs^Qhhf, Wo, Wo, Wo, Ww, Ww, Ds, Ds, Gs^Fp, Gs^Fp, Hh^Fp, Gs^Fp, Gs^Fp, Gg, Gg, Ww, Ww, Gg, Gg, Hh, Gg, Gg^Efm, Gg^Efm, Gg^Efm, Gg^Efm
Hh^Qhhf, Mm, Mm, Mm, Gs^Fp, Gs^Fp, Hh^Qhhf, Hh^Qhh, Wo, Wo, Ww, Ww, Ds, Ds^Esd, Ds, Gs^Fp, Gs^Fp, Gs^Fp, Hh^Fp, Hh^Fp, Hh^Fp, Gs, Gs, Gs, Wwf, Gg, Gg, Gg, Gg^Es, Gg, Gg^Efm, Gg, Rb
Gg^Qhhf, Hh^Fp, Hh^Fp, Hh, Hh^Qhh, Hh^Qhhf, Wo, Wo, Ww, Wo, Ww, Ww, Ww, Ds, Ww, Ds, Gg, Hh^Fp, Gs^Fp, Gs^Fp, Gg, Gg^Edt, Gs^Fp, Gs^Fp, Gs, Wwf, Gg, Gg, Gs, Gs, Re, Rb, Gg
Gs^Qhh, Hh, Gs^Qhh, Hh^Qhh, Ww, Ww, Ww, Ww, Ww, Ww, Gs^Edt, Gg^Edt, Gs, Ww, Gg, Wwf, Wwf, Gg, Gs, Gs^Vl, Gg, Gs^Fp, Gs, Gd^Dr, Wwf, Wwf, Gs, Gg, Gs^Efm, Gs, Re, Gg^Es, Gg
Gs^Qhh, Gs, Gs^Qhh, Hh^Qhh, Ww, Ww, Ww, Ww, Ww, Gs, Gs^Eff, Gs^Eff, Gd^Eff, Gs^Edt, Gs^Edt, Gs, Re^Gvs, Ww^Edt, Ww^Edt, Gs, Gg, Gs^Es, Gs^Edt, Gs^Edt, Ww, Gs, Gs^Efm, Gs^Efm, Gs^Efm, Gg, Rb^Edt, Gg, Gg
Hh^Qhh, Hh, Gg, Ww, Wo, Wo, Ww, Gg, Rb^Gvs, Rb^Gvs, Rb^Gvs, Re^Edt, Re, Gd^Eff, Gd^Dr, Re^Gvs, Re^Edt, Re^Gvs, Re, Ww^Edt, Ww, Ww, Ww, Ww, Gd, Gs, Gd^Edt, Gs^Efm, Gs^Efm, Gs^Efm, Re, Gg, Gg
Hh^Fp, Gg, Wo, Wo, Wo, Ww, Rb^Gvs, Rb^Gvs, Rb^Gvs, Rb^Gvs, Rb^Gvs, Gd^Dr, Chr^Kov, Re, Re^Edt, Re, Re^Gvs, Re, Gd^Vhr, Re^Gvs, Re^Gvs, Re^Gvs, Re^Gvs, Ww^Edt, Ww, Gd, Gd, Gd^Dr, Gs^Edt, Re, Gg, Gg^Efm, Gg
Gs^Fp, Gs^Fp, Wo, Wo, Ww, Ww, Rb^Gvs, Rb^Gvs, Re^Gvs, Re^Gvs, Re^Gvs, Chr, Rb, Gd^Edt, Gs, Re^Gvs, Re^Gvs, Re^Gvs, Hhd^Edt, Hhd, Re^Gvs, Re^Gvs, Re^Gvs, Gs^Dr, Gs^Efm, Ww, Rb, Re, Gd^Edt, Hh, Hh^Qhh, Gg, Gg
Wo, Wo, Ww, Ww, Ww, Rb^Gvs, Rb^Gvs, Re^Gvs, Re^Gvs, Re^Gvs, Re, Rb, Gs^Fp, Rb, Rb, Re^Gvs, Rb^Gvs, Re^Gvs, Re^Gvs, Hhd^Edt, Rb, Rb^Es, Rb, Gs^Edt, Re^Edt, Wwf, Wwf, Hh^Es, Hh, Hh, Hh^Qhh, Hh^Qhh, Hh^Qhh
Ww, Ww, Ww, Wwf, Gs, Rb, Re, Re^Gvs, Gs^Dr, Gd^Edt, Gd^Edt, Rb, Gs^Fms, Gs^Fp, Gs, Re^Gvs, Re^Gvs, Rb, Rb, Rb^Edt, Gd^Eff, Gs^Eff, Re^Gvs, Rb, Re^Gvs, Gs^Vhr, Gs^Edt, Ww, Hh, Hh^Qhh, Hh^Es, Hh, Mm^Qhh
Ww, Wwf, Gg, Gg, Gg^Es, Gg, Rb, Rb, Rb, Rb, Dd, Gs^Fp, Gs^Fp, Gs^Fp, Gs^Edt, Gg^Vhr, Gs^Eff, Re^Gvs, Gd^Eff, Gd^Eff, Gg^Vhr, Re^Gvs, Re^Gvs, Re^Gvs, Rb^Gvs, Re^Gvs, Gs^Dr, Ww^Edt, Ww, Hh^Qhh, Mm, Mm, Mm^Qhh
Wwf, Wwf, Gg, Gg, Re, Gg, Gg, Gs^Edt, Dd^Edt, Dd^Edt, Ds^Do, Gs^Fms, Gs^Es, Gs, Gs^Edt, Gs^Edt, Gs, Gd^Eff, Gs^Fp, Gd^Edt, Gd^Edt, Rb^Gvs, Rb^Gvs, Rb^Gvs, Rb^Gvs, Rb^Gvs, Hh, Ww^Edt, Ww, Hh^Qhh, Hh^Qhh, Mm^_mh, Mm^Qhh
Gg, Gg, Gg^Es, Re, Gs, Gg, Gg, Gg, Gs, Gg^Edt, Gs^Edt, Dd, Gg, Gg, Gs, Gg^Edt, Gs, Gs^Fdw, Gs^Fms, Gs^Fp, Gs, Gs, Gg, Rb^Gvs, Gs^Edt, Gg, Hh^Fp, Hh^Fp, Hh^Fp, Ww, Ww, Hh^Qhh, Hh^Qhh
Re, Re, 1 Rb, Rb, Gs, Hh, Hh, Hh, Hh^Es, Gs, Gg, Gg, Gg^Fp, Gg^Fp, Gs^Fp, Gs, Gs, Gs^Fp, Gs^Fp, Gs^Fp, Gg, Gg^Es, Gg, Gs, Hh, Hh, Hh^Fp, Hh^Fp, Gs^Fms, Hh^Fp, Hh^Fms, Wwf, Hh^Qhh
Gg, Gg, Hh, Gs, Hh, Hh, Hh, Hh, Hh, Gg, Gg, Gg^Fms, Gs^Fp, Gs^Fms, Gs^Fp, Gs^Fp, Gs^Fp, Gs^Fp, Gs^Fp, Gg, Gg, Gg^Efm, Gg, Hh, Gg, Hh^Fp, Gs^Fms, Hh^Fp, Hh^Fp, Hh^Fp, Hh^Fp, Wwf, Ww
