Gs^Fp, Hh, Hh, Hh, Hh, Hh, Hh, Hh, Rp, Hh^Fds, Hh^Qhhf, Hh^Qhhf, Hh^Qhhf, Gs^Qhhf, Md^Qhh, Md^Qhh, Md^Qhh, Mm^Qhh, Mm^Qhh, Mm^Qhh, Wo, Mm^Qhh, Md, Mm^Qhh, Mm^Qhh, Md^Qhh, Md^Qhh, Md^Qhh, Gs^Qhhf, Hh^Qhhf, Hh^Qhhf, Hh^Qhhf, Gs^Fds, Gs, Gs^Fp, Gs, Gs, Gs^Fp, Gs, Gs, Gs, Gs^Fp
Gs^Fp, Gs^Fp, Gs^Fp, Hh, Hh, Hh, Hh, Hh, Rp, Gs^Fp, Hh^Fp, Hh^Qhhf, Hh^Qhhf, Hh^Fp, Md, Md, Md, Mm, Mm, Mm^Qhh, Wo, Mm^Qhh, Mm, Mm, Mm, Md, Md, Md, Gs^Fp, Hh^Qhhf, Hh^Fp, Gs^Fp, Gs^Fms, Gs^Fp, Gs^Fp, Gs, Gs, Gs, Gs, Gs, Gs, Gs^Fp
Gs^Fp, Gs^Fp, Gs^Fp, Gs^Fp, Gs^Fp, Hh, Gs^Fds, Hh, Gs^Fds, Rp, Hh^Fp, Hh^Fp, Hh^Qhhf, Hh^Fp, Hh^Fms, Md, Md, Md, Md, Md^Qhh, Wo, Md^Qhh, Md, Mm, Md, Md^_mh, Md, Md, Hh^Qhhf, Gs^Qhhf, Gs^Fds, Gs^Fds, Gs^Fds, Gg^Fet, Gs^Fp, Gs, Gs^Fp, Gs, Gs, Gs, Gs, Gs
Gs^Fp, Gs^Fp, Gs^Fp, Gs^Fms, Gs^Fp, Gs^Fds, Gs^Fds, Gs^Fds, Gs^Fds, Rp, Gs^Fp, Hh^Fp, Hh^Fp, Hh^Qhhf, Hh^Qhhf, Hh^Fp, Hh^Fp, Md, Hd^_mh, Gs^Qhhf, Wo, Md^Qhh, Md^Qhh, Md, Gs^Fp, Gs^Fp, Hh^Fp, Gs^Qhhf, Hh^Fds, Gs^Fds, Gs^Fds, Gs^Fds, Gs^Fds, Gs^Fds, Gs^Fds, Gs^Fp, Gs^Fp, Gs^Fp, Gs^Fp, Gs, Gs, Gs
Gs^Fp, Gs^Fp, Gs^Fp, Gs^Fp, Gs^Fp, Gs^Fp, Gs^Fds, Gg^Fet, Gs^Fds, Rp, Gs^Fp, Gs^Fp, Gs^Fp, Gs^Fms, Hh^Qhhf, Hh^Fds, Gs^Fp, Hh^Fp, Hh^Fp, Hd^Qhh, Gs^Fp, Wo, Gs^Qhhf, Gs^Fp, Hh^Fds, Hh^Fp, Hh^Qhhf, Hh^Qhhf, Hh^Fds, Gg^Fet, Gs^Fds, Gs^Fds, Gs^Fds, Gs^Fds, Gs^Fds, Gs^Fms, Gs^Fds, Gs^Fds, Gs^Fp, Gs, Gs, Gs
Gs^Fp, Gs^Fp, Gs^Fp, Gs^Fp, Gs^Fp, Gs^Fds, Gs^Fds, Gs^Fds, Gs^Fds, Rp, Rp, Gs^Fp, Gg^Fet, Hh^Fds, Gs^Fds, Hh^Qhhf, Gs^Qhhf, Hh^Fms, Dd^Do, Hd^Qhh, Gs^Fds, Wo, Gs^Qhhf, Gs^Qhhf, Hh^Qhhf, Hh^Qhhf, Gs^Fds, Gs^Fms, Gs^Fds, Gs^Fds, Gs^Fds, Gs^Fds, Gs^Fds, Gs^Fds, Gg^Efm, Gs^Fds, Gs^Fds, Gg^Fet, Gs^Fp, Gs^Fp, Gs, Gs
Gs^Fp, Gs^Fp, Gs^Fp, Gs, Gs, Gs^Fp, Gs^Fms, Gs^Fds, Gs^Fds, Gs^Fds, Rp, Gs^Fp, Hh^Fds, Hh^Fds, Gs^Fds, Gs^Fds, Gg^Fet, Gs^Qhhf, Gs^Qhhf, Hd^Qhh, Gs^Fds, Ww, Ww, Hh^Fds, Gs^Fds, Gs^Fds, Gs^Fds, Gg^Ve, Gs^Fds, Gs^Fds, Gs^Fds, Gs^Fds, Cv^Fet, Cv, Gg^Efm, Gg^Efm, Gg^Efm, Gs^Fp, Gs^Fp, Gs^Fp, Gs, Gs
Gs, Gs^Fp, Gs, Gs, Gs, Gs^Fp, Gs^Fds, Gs^Fds, Gs^Fp, Gs^Fds, Gs^Fds, Rp, Rp, Hh^Fds, Gs^Fds, Gs^Fds, Gs^Fds, Gs^Fds, Hh^Fds, Gs^Fds, Gs^Fds, Gs^Fds, Ww, Gs, Gs, Gs^Fds, Gs^Fds, Gs^Fds, Gs^Fds, Gs^Fds, Gs^Fds, Gs^Fds, Cv, Gg^Efm, 2 Kv, Cv, Gg^Efm, Gs^Fp, Gs^Fp, Gs, Gs, Gs
Gs, Gs, Gs, Gs, Gs^Fp, Gs^Fp, Gs^Fds, Gs^Fds, Gs^Fds, Gs^Fds, Gs^Fds, Hh^Fds, Rp, Gs^Fds, Gs^Fds, Gs^Fds, Gs^Fds, Gs^Fds, Gs^Fds, Gs^Fds, Ww, Ww, Hh^Fds, Gg, Gg, Gg, Gs^Fds, Gs^Fds, Gs^Fds, Gs^Fds, Gs^Fds, Gs^Fds, Rp, Gg^Efm, Cv, Cv, Gg^Efm, Gs^Fp, Gs^Fp, Gs, Gs, Gs
Gs, Gs, Gs, Gs, Gs, Gs^Fp, Gs^Fp, Gs^Fms, Gs^Fds, Gs^Fds, Gs^Fds, Hh^Fds, Hh^Fds, Rp, Gs^Fds, Gg^Fet, Gs^Fds, Gs^Fp, Gg^Ve, Gs^Fds, Ww, Hh^Fds, Gs^Fds, Gg^Fds, Rp, Rp, Rp, Rp, Rp, Rp, Rp, Rp, Gs^Fds, Gg^Efm, Gg^Efm, Gg^Efm, Gs^Fp, Gs^Fp, Gs, Gs, Gs, Gs
Gs^Fp, Gs, Gs, Gs, Gs, Gs, Gs^Fp, Gs^Fds, Gg^Fet, Gs^Fds, Gs^Fds, Hh^Fds, Hh^Fds, Rp, Rp, Gs^Fds, Gs^Fds, Gs^Fds, Gs^Fds, Ww, Hd, Hh^Fds, Gs^Fds, Rp, Gs^Fds, Gs^Fds, Gs^Fds, Gs^Fds, Gs, Gg, Gs, Gs^Fds, Gs^Fds, Gs^Fds, Gs^Fds, Gs^Fds, Gs^Fp, Gs, Gs^Fp, Gs, Gs, Gs
Gs, Gs, Gs, Gs, Gs^Fp, Gs, Gs^Fp, Gs^Fds, Gs^Fds, Gs^Fds, Gs^Fds, Hh^Fds, Gs^Fds, Gs^Fds, Gs, Rp, Rp, Gs^Fds, Gs^Fds, Ww, Hd, Dd^Do, Rp, Rp, Gg, Gs^Fds, Gs^Fds, Gg^Fet, Gs^Fds, Gs, Gg, Gs^Fds, Gs^Fds, Gs^Fds, Gs^Fds, Gs^Fms, Gs^Fp, Gs^Fp, Gs^Fp, Gs^Fp, Gs, Gs
Gs, Gs, Gs, Gs^Fp, Gs^Fp, Gs^Fp, Gs^Fds, Gs^Fds, Gs^Fds, Gs^Fds, Hd, Hd, Gg^Fet, Gg, Gg, Gs^Fds, Gs^Fds, Rp, Gs^Fds, Ww, Ww^Bw/, Rp, Hh, Gg, Gs, Gs^Fds, Gs^Fds, Gs^Fds, Gs^Fds, Gg^Fet, Gs^Fds, Gs^Fds, Gs^Fds, Gs^Fds, Gs^Fds, Gs^Fds, Gs^Fp, Gg^Ve, Gs^Fp, Gs^Fds, Gs, Gs
Gs, Gs, Gs, Gs^Fp, Gs^Fds, Gs^Fds, Gs^Fds, Gg^Fet, Gs^Fp, Hd, Hh^Qhhf, Dd^Do, Hh^Qhhf, Gg, Hh, Gs^Fds, Gs^Fds, Rp, Rp, Rp, Gs^Fds, Ww, Hh^Fds, Hh^Fds, Gs^Fds, Gg^Ve, Gs, Gs^Fds, Gs^Fds, Gs^Fds, Gs^Fds, Gs^Fds, Gs, Gg^Fet, Gs^Fds, Gs^Fp, Gs^Fp, Gs^Fp, Gs, Gs, Gs, Gs
Gs^Fp, Gs, Gs, Gs^Fp, Gs^Fp, Gs^Fms, Gs^Fds, Gs^Fds, Gs^Fds, Gs^Fds, Hh^Qhhf, Hh^Qhhf, Hh^Fds, Gs^Qhhf, Hh, Hh, Gs, Gs, Rp, Gg^Ve, Gg^Fet, Ww, Ww^Qhu, Hh^Fds, Ww^Qhu, Gs^Fds, Gs, Gs, Gg^Fet, Gs^Fds, Gs^Fds, Gs^Fds, Gs^Fms, Gs, Gs^Fds, Gs^Fp, Gs^Fp, Gs^Fp, Gs, Gs, Gs, Gs
Gs^Fp, Gs, Ce, Gs, Gs^Fp, Gs^Fp, Gs^Fp, Gs^Fds, Gs^Fds, Gs^Fds, Gg^Qhhf, Md, Md^_mh, Hh^Qhhf, Gs^Qhhf, Gs^Fds, Gs^Fds, Gs, Rp, Gs^Fds, Wwf, Ww, Gs^Fds, Ww^Qhu, Wwf^Qhu, Hh^Fds, Hh^Fds, Gs^Fds, Gs^Fds, Gs^Fds, Ds^Fds, Dd^Do, Hd, Gs^Fds, Gs^Fds, Gs^Fms, Gs^Fp, Gs^Fp, Gs^Fp, Gs, Gs, Gs
Gs^Fp, Ce, 1 Ke, Ce, Gs, Gs^Fp, Rp, Gs^Fds, Rp, Gs^Fds, Gs^Fds, Hh^Qhhf, Hh^Qhhf, Hh^Qhhf, Gs^Qhhf, Gs^Qhhf, Gs^Fds, Gs^Fds, Rp, Ww, Ww, Gs^Fds, Gs, Gs^Fds, Ww^Qhu, Hh^Fds, Hh^Fds, Hh^Fds, Hh^Fds, Gs^Fds, Hd, Hd, Rp, Rp, Rp, Gs^Fds, Rp, Gs^Fp, Gs^Fp, Gs, Gs, Gs
Gs^Fp, Ce, Ce, Ce, Re, Rp, Gs^Fp, Rp, Gs^Fds, Rp, Rp, Gs^Fds, Rp, Gs^Fds, Rp, Gs, Rp, Rp, Ww, Ww, Gs^Fds, Wwf, Ww, Gs^Fds, Ww, Hh^Fds, Hh^Fds, Hh^Fds, Gs^Fp, Hh^Fds, Rp, Rp, Gs^Fds, Gs^Fds, Gs^Fds, Rp, Gs^Fds, Rp, Rp, Gs, Re, Re
Gs^Fp, Gs, Re, Re, Gs, Gs^Fp, Gg^Ve, Gs^Fds, Gs^Fds, Gs^Fds, Gs^Fds, Rp, Gs^Fds, Rp, Gg^Ve, Rp, Ww^Bw\, Ww, Gs, Gs^Fds, Hh^Fds, Gs^Fds, Gs^Fds, Ww, Ww^Qhu, Gg^Ve, Gs^Fp, Gs^Fp, Rp, Rp, Gs^Fds, Gs^Fds, Gs^Fds, Gg^Fet, Gs^Fds, Gs^Fds, Gs^Fds, Gs^Fp, Gs^Fp, Re, Gs, Gs
Re, Re, Gs, Gs, Gs^Fp, Gs^Fds, Gg^Fet, Hh^Fds, Hh^Fds, Hh^Fds, Hh^Fds, Gs^Fds, Gs^Fds, Gs^Fds, Ww^Qhu, Ww^Qhu, Gg, Rp, Rp, Rp, Rp, Hh^Fds, Hh^Fds, Gs^Fds, Gs^Fds, Ww^Qhu, Ww^Qhu, Gs^Fp, Rp, Gs^Fds, Gs^Fds, Gs^Fds, Gs^Fds, Gs^Fds, Gs^Fds, Gs^Fds, Gs^Fds, Gs^Fds, Gs^Fp, Gs, Gs, Gs
Gs^Fp, Gs, Gs, Gs, Gs^Fp, Gs^Fds, Gs^Fds, Gs^Fds, Hh^Fds, Hh^Fds, Hh^Fds, Gs^Fds, Ww^Qhu, Ww^Qhu, Gs^Fds, Gg, Gs^Fds, Gs, Rp, Dd^Do, Hd, Rp, Rp, Gg^Ve, Gg^Fet, Gs^Fds, Rp, Wwf^Qhu, Ww^Qhu, Gs^Fds, Gg^Fet, Gs^Fds, Gs^Fds, Gs^Fds, Gg^Fet, Gs^Fds, Gs^Fms, Gs^Fds, Gg^Ve, Gs^Fp, Gs^Fp, Gs^Fds
Gs^Fp, Gs, Gs, Gs, Gs^Fp, Gs^Fp, Gs^Fds, Gs^Fds, Gs^Fds, Hh^Fds, Hh^Fds, Gs^Fds, Ww^Qhu, Gs^Fds, Gs^Fds, Gs^Fds, Rp, Rp, Gs^Fp, Gs^Fp, Hd, Hd, Rp, Gs^Fp, Gs^Fp, Rp, Gs^Fp, Gs^Fp, Ww^Qhu, Gg, Gs, Gs^Fds, Gs, Gg, Gg, Gs^Fds, Gs^Fds, Gs^Fds, Gs^Fp, Gs^Fp, Gs, Gs^Fp
Gs, Gs, Gs, Gs^Fp, Gs^Fp, Gs^Fds, Gs^Fds, Gg^Fet, Gs^Fds, Gs^Fds, Hh^Fds, Hh^Fds, Ww^Qhu, Gs^Fds, Rp, Rp, Gs^Fp, Gs^Fp, Gs^Fp, Gs^Fp, Hh^Fds, Hh^Fds, Gs^Fds, Rp, Rp, Rp, Hh^Fp, Hh^Fp, Ww^Qhu, Gs, Gs^Ve, Gs, Gs^Fds, Gg, Gs^Fds, Gs^Fds, Gs^Fms, Gs^Fds, Gs^Fp, Gs, Gs, Gs
Gs, Gs, Gs, Gs^Fp, Gs^Fds, Gs^Fds, Gs^Fds, Gs^Fds, Gs^Fds, Gg^Fet, Ww^Qhu, Wwf^Qhu, Rp, Rp, Hh^Fds, Gs^Fp, Gs^Fp, Gg^Fet, Gs^Fp, Hh^Fds, Hh^Fds, Hh^Fds, Gs^Fms, Rp, Rp, Gs^Fp, Hh^Fp, Hh^Fp, Gs^Fds, Ww^Qhu, Ww^Qhu, Gs^Fds, Gs^Fds, Gs^Fds, Gs^Fds, Gs^Fds, Gs^Fds, Gs^Fp, Gs^Fp, Gs, Gs, Gs
Gs^Fp, Gs, Gs^Fp, Gs^Fp, Gs^Fp, Gg^Fet, Gs^Fds, Gs^Fds, Gs^Fds, Gs^Fds, Ww^Qhu, Hh, Rp, Hh^Fds, Hh^Fds, Hh^Fds, Hh^Fds, Gs^Fp, Gg^Ve, Hh^Fds, Gs^Fds, Gs^Fds, Gs^Fds, Gs^Fds, Rp, Gs^Fp, Gs^Fp, Hh^Fp, Gs^Fds, Gs^Fds, Gs^Fds, Ww^Qhu, Ww^Qhu, Gs^Fds, Gs^Fds, Gs^Fds, Gs^Fds, Gs^Fp, Gs, Gs, Gs, Gs^Fp
Gs, Gs, Gs, Gs^Fds, Gs^Fp, Gs^Fds, Gs^Fds, Gs^Fds, Ww^Qhu, Ww^Qhu, Gs^Fp, Hh, Rp, Gs^Fds, Gs^Fds, Hh^Fds, Hh^Fds, Hh^Fds, Gs^Fp, Hh^Fds, Gs^Fds, Gs, Gs, Gs, Gs^Fds, Rp, Rp, Hh^Fp, Gg^Fds, Gg^Fet, Gg^Fds, Gs^Fds, Gs^Fds, Ww^Qhu, Gg^Fet, Gs^Fds, Gs^Fds, Gs^Fp, Gs^Fp, Gs, Gs, Gs^Fp
Gs, Gs, Ss, Gs^Fp, Ww^Qhu, Ww^Qhu, Ww^Qhu, Ww^Qhu, Gg^Efm, Gs^Fp, Gg^Ve, Gs^Fp, Rp, Gs^Fms, Gs^Fds, Gg^Fet, Gs^Fds, Hh^Fds, Hh, Hh^Fds, Gs, Gs, Gg^Fet, Gs^Fds, Gs^Fds, Gg^Fet, Rp, Gg^Fms, Gg, Gg, Gs, Gs^Fds, Gs^Fds, Ww^Qhu, Ww^Qhu, Gs^Fds, Gs^Fds, Gs^Fds, Gs^Fp, Gs, Gs, Gs
Gs^Fp, Ss, Ww^Qhu, Ww^Qhu, Gs^Fds, Gs^Fds, Gg^Efm, Gg^Efm, Cv, Gg^Efm, Rp, Rp, Gs^Fds, Gs^Fds, Gs^Fds, Gs^Fds, Gs^Fds, Hh, Hh, Hh^Fds, Gs^Fds, Gs, Gs^Fds, Gs^Fms, Gs^Fds, Gs^Fds, Rp, Gg, Gs, Gs, Gs, Gs^Fds, Gs^Fds, Gs^Fds, Gs^Fds, Ww^Qhu, Gs^Fds, Gs^Fds, Gs^Fp, Gs, Gs^Fp, Gs
Ww^Qhu, Ww^Qhu, Ss, Gs^Fp, Gs^Fds, Gs^Fds, Gg^Efm, Cv, 3 Kv, Cv, Gg^Efm, Gs^Fds, Gs^Fds, Gs^Fds, Gs^Fds, Gs^Fds, Gs^Fds, Hh, Gs, Gs, Gs^Fds, Gs^Fds, Gs^Fds, Gs^Fds, Gs^Fms, Gs^Fds, Gs^Fds, Rp, Rp, Gs^Fds, Gs^Fds, Gs^Fds, Gs^Fds, Gs^Fds, Gs^Fds, Ww^Qhu, Gs^Fds, Gs^Fds, Gs^Fds, Gs^Fp, Gs^Fp, Gs^Fds
Ss^Qhu, Ss^_ml, Ss, Gs^Fp, Gs^Fds, Gs^Fds, Gg^Efm, Cv, Cv, Cv, Gg^Efm, Gs^Fds, Gs^Fms, Gs^Fds, Hh^Fds, Gs^Fds, Hh^Fds, Hh, Gs^Fds, Gs^Fds, Gs^Fds, Gs^Fds, Gg^Fet, Gs^Fds, Gs^Fms, Gs^Fds, Gg^Ve, Gs^Fds, Gs^Fds, Rp, Gs^Fds, Gs^Fds, Gs^Fds, Gs^Fds, Gs^Fds, Ww^Qhu, Gs^Fds, Gs^Fds, Gs^Fds, Gs^Fms, Gs^Fp, Gs^Fds
Ss^Qhu, Ss, Gs^Fp, Gs^Fp, Gs^Fds, Gs^Fds, Gs^Fds, Gg^Efm, Gg^Efm, Gg^Efm, Gs^Fds, Gs^Fds, Gs^Fds, Gs^Fds, Hh^Fds, Hh^Fds, Hh^Fds, Gs^Fds, Gs^Fds, Gs^Fds, Hd, Gs^Fds, Gs^Fds, Gs^Fds, Gs^Fds, Gs^Fds, Gs^Fds, Gs^Fds, Rp, Rp, Gs^Fds, Gs^Fds, Gs^Fds, Gs^Fds, Gs^Fds, Ww^Qhu, Ww^Qhu, Gs^Fds, Gs^Fds, Gs^Fds, Gs^Fp, Gs^Fds
Gs^Qhu, Gs, Gs, Gs^Fp, Gs^Fms, Gs^Fds, Gs^Fms, Gs^Fds, Gs^Fds, Gs^Fms, Gs^Fds, Gs^Fds, Gs^Fds, Gs^Fds, Hh^Fds, Hh^Fds, Hh^Fds, Gs^Fds, Gs^Fds, Hd, Hd, Gs^Fds, Hh^Fms, Hh^Fms, Hh^Fms, Gs^Fds, Gs^Fds, Rp, Gs^Fds, Gs^Fds, Gs^Fds, Gs^Fms, Gs^Fds, Gg^Fet, Gs^Fds, Gs^Fds, Gs^Fds, Ww^Qhu, Gs^Fds, Gg^Fet, Gs^Fp, Gs^Fds
Gs^Qhu, Gs, Gs, Gs^Fp, Gs^Fp, Gs^Fds, Gg, Gs^Fds, Hh^Fds, Gs^Fds, Gs^Fds, Gs^Fds, Gg, Gg, Gs, Hh^Fds, Hh^Fds, Gs^Fds, Gs^Fp, Hd, Hd, Gs^Fds, Hh^Fms, Hh^Fms, Hh^Fms, Hh^Fms, Gs^Fds, Rp, Gs^Fds, Gs^Fds, Gs^Fds, Gs^Fds, Gs^Fds, Gs^Fds, Gs^Fds, Gg^Fet, Gs^Fds, Ww^Qhu, Gs^Fds, Gs^Fds, Gs^Fp, Gs^Fds
Gs^Fp, Gs, Gs, Gs^Fp, Gs^Fp, Gs, Hh^Fds, Hh^Fds, Hh^Fds, Gs^Fds, Gs^Fds, Gg, Gs^Fds, Gg, Gs^Fds, Gs^Fp, Gs^Fp, Gs^Fp, Gs^Fp, Gs^Fp, Hd^Qhux, Hh^Qhux, Hh^Qhux, Hh^Qhux, Hh^Qhux, Hh^Fms, Hh^Fms, Rp, Gs^Fds, Gs^Fds, Gg^Fet, Gs^Fds, Cv, Gs^Fms, Gs^Fds, Gs^Fds, Gs^Fds, Ww^Qhu, Gs^Fds, Gs^Fds, Gs^Fds, Gs^Fds
Hh^Fds, Hh^Fp, Hh^Fp, Hh^Fp, Gs^Fp, Gs, Gs^Fp, Hh^Fds, Hh^Fds, Gs^Fds, Hh^Fds, Gs^Fds, Hh^Fds, Gs^Fds, Hh^Qhux, Gs^Qhux, Hh^Qhux, Hh^Qhux, Hh^Qhux, Hh^Qhux, Md, Md, Md, Md, Md, Hh^Qhux, Md^Qhux, Rp, Rp, Gs^Fds, Hh^Fds, Cv, 4 Kv, Gs^Fds, Cv, Gs^Fds, Hh^Fds, Ww^Qhu, Ww^Qhu, Gs^Fds, Gg^Fet, Gs^Fds
Md, Md, Md, Hh^Fp, Md, Hh^Fp, Gs^Fp, Hh^Fds, Gs^Fp, Gs^Fds, Hh^Qhux, Hh^Qhux, Hh^Qhux, Md^Qhux, Hh^Fds, Hh^Qhux, Md, Md, Mm, Mm^_mll, Mm, Md, Mm, Mm, Mm, Mm, Md^Qhux, Gs^Fds, Rp, Hh, Hh, Hh^Fds, Gs^Fds, Gs^Fms, Cv, Hh^Fds, Hh^Fds, Hh^Fds, Ww^Qhu, Gs^Fds, Gs^Fds, Gs^Fds
Hh^Fp, Hh^Fp, Hh^Fp, Md, Gs, Hh, Hh^Fp, Hh^Fds, Hh^Fds, Hh^Qhux, Hh^Fds, Hh^Fds, Gs^Fp, Hh^Fp, Gs^Fp, Hh^Fds, Gs^Fp, Md, Mm, Mm, Mm, Mm, Mm, Mm, Mm, Mm, Mm, Md^Qhux, Rp, Hh, Hh, Hh^Fds, Gs^Fds, Cv, Gs^Fds, Hh^Fds, Hh^Fds, Hh^Fds, Ww^Qhu, Gs^Fds, Gs^Fds, Gs^Fds
