Aa^Fpa, Aa^Fpa, Aa^Fpa, Aa^Fpa, Ha, Ha, Ha, Hh, Ha, Ww, Hh, Hh, Hh, Hh, Hh, Hh, Mm, Mm^Xm, Mm^Xm, Mm, Ms^Xm, Mm, Ms, Mm, Ms^Xm, Ms^Xm, Ms^Xm, Gg, Ms^Xm, Gg, Ha, Ha, Ww, Mm, Mm^Xm, Gg, Ha, Hh, Ha, Aa^Fpa, Ha, Gs^Fp
Aa^Fpa, Aa^Fpa, Aa^Fpa, Aa^Fpa, Ms, Ha^Esa, Ms^Xm, Ms^Xm, Ms^Xm, Ha^Esa, Mm, Hh, Hh, Hh^Es, Hh, Hh, Hh, Mm^Xm, Hh, Mm^Xm, Hh, Ms, Mm, Ms, Ms, Ms, Ms, Mm^Xm, Ms, Ha^Es, Ha^Esa, Ww, Ww, Mm^Xm, Mm^Xm, Ms^Xm, Ms^Xm, Ms^Xm, Ms^Xm, Ha, Ms, Ha
Aa^Fpa, Aa^Fpa, Aa^Fpa, Aa^Fpa, Ms, Ms, Ms, Ms^Xm, Ms^Xm, Ms, Ms, Mm^Xm, Mm^Xm, Mm^Xm, Mm, Ms, Ms^Xm, Gs^Fp, Ms^Xm, Hh^Es, Hh, Hh^Fp, Hh^Fp, Ha^Fpa, Ha^Fpa, Ha^Fpa, Hh, Ms, Ha, Ha, Ww, Ww, Mm, Mm^Xm, Cf, Cf, Cf, Ms^Xm, Ms^Xm, Ms^Xm, Ms^Xm, Ms^Xm
Hh^Fp, Aa^Fpa, Aa^Fpa, Aa^Fpa, Gs^Fp, Ha, Gg^Vhr, Ha, Hh, Ms, Hh, Mm, Mm, Mm, Ms, Ms, Ms, Ms^Xm, Ms, Ms^Xm, Ms, Hh^Fp, Hh^Fp, Hh^Fp, Hh^Fp, Hh^Fp, Wwf, Ww, Ww, Wwf, Gs, Hh, Gs, Mm, Hhd, 2 Kf, Cf, Ms^Xm, Ms, Ms, Ms, Ms
Hh, Hh^Fp, Gs^Fp, Gs^Fp, Gg, Rb^Gvs, Rb^Gvs, Rb^Gvs, Gs^Fp, Hh, Hh^Fp, Hh^Fp, Hh^Fp, Gs^Fp, Gs^Fp, Mm, Gs^Fp, Ms, Mm, Ms, Gs, Mm, Gs, Hh^Fp, Ww, Wwf, Hh, Gg, Hh, Hh, Hh, Gs^Ebn, Hh, Hhd, Hhd, Gs, Hhd, Hhd, Hhd^Vud, Cf, Ms, Ms
Mm, Hh, Hh^Fp, Gg, Gg^Es, Gs^Fp, Rb^Gvs, Rb^Gvs, Mm, Mm^Xm, Mm, Gs^Fp, Hh^Fp, Hh^Fp, Hh^Fp, Hh^Fp, Hh^Fp, Gs^Fp, Rb^Gvs, Rb^Gvs, Re^Gvs, Gs^Dr, Ww, Ww, Mm, Hh, Mm^Xm, Hh, Hh, Mm, Mm^Xm, Hh^Vud, Mm^Xm, Hhd, Hhd, Gd^Es, Gs, Gd^Ebn, Hhd, Hhd, Hhd, Hhd
Hh^Fp, Mm, Mm, Hh^Fp, Hh^Fp, Re^Gvs, Rb^Gvs, Rb^Gvs, Hh^Fp, Mm, Mm, Mm, Mm, Mm, Mm, Hh, Ha, Hh^Fp, Ha, Re^Gvs, Rb^Gvs, Ww, Gs, Hh, Hh, Mm, Cf, Mm^Xm, Mm, Mm, Mm, Mm^Xm, Ms, Ms^Xm, Ms^Xm, Ms, Hhd, Gs, Hhd, Gd, Hhd^Es, Gd
Hh^Fp, Hh^Fp, Hh^Fp, Mm, Hh^Fp, Gs^Fp, Hh^Fp, Rb^Gvs, Rb^Gvs, Hh^Fp, Hhd^Vhhr, Mm, Mm, Mm, Cfr^Dr, Mm, Ms, Ha, Ms, Ha^Vhha, Ha, Wwf, Wwf, Hh^Es, Gs, Hh^Fp, Hh^Fp, Mm, Hhd, Mm, Mm, Mm, Mm, Ms^Xm, Ms, Ms^Xm, Ms, Ms, Ms, Ww, Wwf, Wwf
Hh^Fp, Mm, Mm, Hh^Fp, Ms, Ha, Cfr, Rb^Gvs, Rb^Gvs, Rb^Gvs, Ha^Fma, Gs^Fp, Gs^Fp, Mm, Cfr, Kfr, Mm, Ms, Ms, Ms^Xm, Ms, Wwf, Mm, Ww, Ww, Hh^Fp, Gd, Hhd, Hhd, Hhd^Es, Hhd^Es, Hhd, Hh, Hh, Hhd, Ms, Cf, Ms, Ww, Ww, Hhd, Hh
Hh, Mm, Hh^Fp, Mm, Ms, Ms, Ms, Ms, Ms, Ha^Fma, Ha^Fma, Ha^Fma, Ha, Hh, Hh, Mm, Mm, Ms^Xm, Ms^Xm, Ms^Xm, Hh, Mm, Hh^Fp, Mm, Ww, Ww, Ww, Gd^Dr, Gd^Es, Hh, Gs, Hh, Gg^Dr, Gs, Ww, Hh, Ww, Ww, Hhd, Hhd, Hh, Hh
Hh, Hh, Hh, Hh, Hh, Ms, Mm, Ha, Ha, Ms, Ms, Ha, Ha^Es, Ha^Esa, Ha, Mm, Mm, Ms, Ms, Ms^Xm, Ms^Xm, Mm, Hh^Fp, Ha, Ha, Ww, Ww, Wwf, Wwf, Gs, Wwf, Gs, Ww, Ww, Hh, Ww, Hhd, Hhd, Hhd, Hhd, Hh, Hh
Gg, Gg, Gg, Gg, Hh, Gg, Hh, Hh, Hh^Es, Ha^Esa, Mm, Ms, Mm, Gg, Hhd, Gg, Hhd^Vhhr, Ms, Ms, Mm, Ms^Xm, Ms^Xm, Ms^Xm, Mm, Ms^Xm, Hh^Fp, Ha, Gg, Hhd, Ww, Gs, Ww, Ww, Hh, Gs^Dr, Hhd, Rb, Hhd, Re^Gvs, Re^Dr, Re^Gvs, Gg
Gg, Gg^Es, Gg, Gg, Rb^Gvs, Hh, Rb^Gvs, Hh, Hh, Hh, Hh, Mm, Mm^Xm, Md, Md, Hhd, Hhd, Md, Md, Ms, Hh, Ms^Xm, Mm, Ms^Xm, Mm, Ms^Xm, Ms, Mm, Mm, Hhd^Es, Gd^Es, Ww, Ww, Re^Gvs, Re^Gvs, Rb, Rb^Gvs, Rb^Gvs, Rb^Gvs, Re^Gvs, Re^Gvs, Re^Gvs
Gs^Fp, Hh^Fp, Hh^Fp, Gg^Vhr, Re^Gvs, Rb^Gvs, Rb^Gvs, Re^Gvs, Hh, Hh, Hh, Mm, Mm^Xm, Md^Xm, Md^Xm, Hhd, Ww, Hhd, Hh, Mm, Hh, Hh, Ww, Mm, Ww, Mm, Wwf, Mm, Mm, Hhd, Hh, Ww, Gs, Rb^Gvs, Rb^Gvs, Re^Gvs, Gd^Vhr, Rb^Gvs, Rb^Gvs, Rb^Gvs, Rb^Gvs, Re^Gvs
Gs^Fp, Gs^Fp, Gs^Fp, Gs^Fp, Gs^Fp, Re^Gvs, Gg, Re^Gvs, Gg, Gg^Vhr, Ww, Mm, Mm, Mm, Mm, Mm, Ww, Ww, Ww, Ww, Ww, Ww, Ww, Ww, Re^Gvs, Wwf, Wwf, Wwf, Ww, Wwf, Ww, Ww, Rb^Gvs, Hhd^Es, Hhd, Hhd, Hhd, Hhd, Gs, Rb^Gvs, Rb^Gvs, Rb^Gvs
Gs^Fp, Gs^Fp, Gs^Fp, Gs^Fp, Gs^Fp, Gg, Gg, Ss, Ww, Ww, Hh^Fp, Ww, Ww, Ww, Wwf, Wwf, Hh^Fp, Mm, Mm, Hh, Hh, Hhd, Hhd, Re^Vhr, Rb^Gvs, Rb^Gvs, Hh, Hh, Mm, Ww, Rb^Gvs, Rb^Gvs, Re^Gvs, Gs^Dr, Hh, Hhd, Md, Hh^Es, Hh, Hh, Hh, Rb^Gvs
Gg, Gs^Fp, Gs^Fp, Gs^Fp, Gg, Gg, Ss, Ss, Wwf, Hh^Fp, Hh^Fp, Hh^Fp, Hh^Fp, Hh^Fp, Hh^Fp, Hh^Fp, Hh^Fp, Hh, Hh, Hh^Es, Hh, Mm, Mm, Hh^Fp, Hh^Fp, Hh^Fp, Hh, Mm, Mm^Xm, Gg^Vhr, Hh, Rb^Gvs, Rb^Gvs, Hh, Hh, Hh, Hh, Md, Hh, Hh, Hh^Es, Hh
Gg, Gg, Gs^Fp, Gs^Fp, Gg, Gg, Ss, Ss, Ww, Gs^Fp, Gs^Fp, Gs^Fp, Gs^Fp, Gs^Fp, Gs^Fp, Gs^Fp, Re^Gvs, Rb^Gvs, Rb^Gvs, Hh, Hh, Mm, Cfr, Mm, Mm, Gs^Fp, Mm, Mm, Mm, Mm, Hh, Hh^Es, Gg, Rb^Gvs, Rb^Gvs, Rb^Gvs, Re^Gvs, Gg^Vhr, Hh, Md, Md, Hh
Gg, Gg, Gg, Gg, Gg^Es, Gg, Gg, Ww, Ss, Ss, Gg, Gs^Fp, Re, Gg, Gg, Rb^Gvs, Re^Gvs, Re^Gvs, Gs^Fp, Hh, Hh, Mm, Mm, Hh^Fp, Mm, Mm, Mm, Hh, Hh, Mm, Mm, Gg, Hh, Hh, Cfr, Rb^Gvs, Re^Gvs, Re^Gvs, Hh, Md, Md, Mm
Gs^Fp, Gs^Fp, Gg, Gg, Ce, Gg, Gg, Ww, Ss, Gg, Gg, Re^Es, Gg, Rb, Gs^Fp, Re^Vhr, Gs^Fp, Gs^Fp, Gs^Fp, Gs^Fp, Gs^Fp, Hh, Hh^Fp, Mm, Mm, Mm^Xm, Mm^Xm, Mm, Hh^Fp, Hh^Fp, Hh, Mm, Mm, Cfr^Dr, Kfr, Hh, Hh^Dr, Gs^Es, Gg, Hh, Hh, Gg
Gs^Fp, Gs^Fp, Gs^Fp, Ce, 1 Ke, Gg, Wwf, Ww, Gg, Re, Re, Gg, Gs^Fp, Gs^Fp, Gs^Fp, Gs^Fp, Gs^Fp, Gs^Fp, Gs^Fp, Gs^Fp, Gs^Fp, Gg, Hh, Hh, Hh^Es, Mm, Mm^Xm, Mm^Xm, Mm, Hh^Fp, Gs^Fp, Hh, Hh^Gvs, Mm, Mm, Mm, Mm, Hh, Hh, Gs^Fp, Gs^Fp, Hh
Gs^Fp, Gs^Fp, Gs^Fp, Gg, Ce, Ce, Wwf, Gg, Rb, Re, Gg, Gg, Gs^Fp, Gs^Fp, Gs^Fp, Gs^Fp, Gs^Fp, Gs^Fp, Gs^Fp, Gs^Fp, Gs^Fp, Gg, Gs, Hh, Gg, Hh, Hh, Hh, Hh, Hh^Fp, Hh^Fp, Gg, Hh^Gvs, Mm, Hh, Mm, Hh, Mm, Mm, Mm, Mm^Xm, Gs^Fp
Gg, Gs^Fp, Gg, Gg, Gg, Wwf, Gg, Rb, Gg, Re, Gg, Gg, Gs^Fp, Gs^Fp, Gs^Fp, Gs^Fp, Gs^Fp, Gs^Fp, Gs^Fp, Gs^Fp, Gg, Gg, Gs, Gs, Gs, Gs, Gg, Gg, Gg, Hh, Gs^Fp, Hh^Fp, Hh^Fp, Hh^Gvs, Hh, Hh^Es, Hh, Hh, Hh, Mm, Mm^Xm, Mm^Xm
