Xu, Xu, Xu, Xu, Xu, Xu, Uu, Urb, Urb, Uu, Uu, Cud, Xu, Xu, Xu, Qxu, Qxu, Qxu, Qxu, Xu, Xu, Qxu, Xu, Xu, Xu, Xu, Uu, Urb, Uu, Xu
Xu, Xu, Xu, Xu, Xu, Xu, Cud, Uu, Uu, Urb, Urb, Uu, Xor, Xor, Xu, Xor, Qxu, Qxu, Qxu, Qxu, Qxu, Qxu, Xor, Xor, Xu, Xor, Uu, Urb, Uu, Xu
Xu, Xu, Xu, Xu, Xu, Xu, Xu, Cud^Xo, Xu, Uu, Urb, Ur, Ur, Xor, Xu, Qxu, Cud, Qxu, Qxu, Qxu, Cud, Qxu, Xu, Xor, Ur, Cud, Cud, Urb, Uu, Xu
Qxu, Xu, Qxu, Xu, Xu, Xu, Xu, Xu, Xu, Xor, Xor, Urb, Urb, Ur, Ur, Cud^Eb, Cud, Cud, Qxu, Cud, Cud, Cud^Eb, Ur, Ur, Urb, Urb, Ur, Cud, Xu, Xu
Qxu, Qxu, Xu, Qxu, Qxu, Qxu, Qxu, Xu, Xu, Xu, Xor, Ur, Ur, Urb, Urb, Ur, Ur, Qxu, Qxu, Qxu, Ur, Ur, Urb, Urb, Ur, Ur, Xu, Xor, Xu, Xu
Xu, Xu, Xu, Qxu, Qxu, Qxu, Qxu, Xu, Xu, Xu, Xor, Ur^Vud, Ur, Cud, Cud, Urb, Qxu^Bcx\, Qxu, Urb, Urb, Cud, Urb, Cud, Ur, Xu, Cud^Xo, Xu, Xu, Xu, Xu
Qxu, Xu, Qxu, Qxu, Qxu, Qxu, Qxu, Qxu, Qxu, Qxu, Qxu, Cud^Xo, Cud, Cud, Qxu, Qxu, Qxu, Urb, Ur^Vud, Cud, Cud, Qxu, Xu, Xu, Xu, Xu, Xu, Xu, Xu, Xu
Qxu, Qxu, Qxu, Qxu, Xu, Qxu, Qxu, Qxu, Qxu, Qxu, Qxu, Qxu, Qxu^Bcx|, Qxu, Qxu, Qxu, Ur^Vud, Urb, Cud, Cud, 2 Kud, Cud, Xu, Xu, Xu, Xu, Xu, Xu, Xu, Xu
Xu, Qxu, Qxu, Qxu, Qxu, Xu, Qxu, Qxu, Qxu, Qxu, Qxu, Qxu, Cud, Qxu, Qxu, Qxu, Qxu, Urb, Ur^Vud, Cud, Cud, Cud, Xu, Xu, Xor, Xu, Xu, Xu, Xu, Xu
Xu, Xu, Xu, Qxu, Xu, Qxu, Qxu, Qxu, Qxu, Xu, Xor, Cud^Xo, Ur, Cud, Cud, Qxu, Qxu^Bcx/, Urb, Urb, Cud, Cud, Qxu, Cud, Xu, Xor, Xor, Xu, Xu, Xu, Xu
Xu, Xu, Xu, Xu, Xu, Xu, Xu, Xu, Xor, Xor, Xor, Uu^Vud, Ur, Cud, Urb, Urb, Ur, Qxu, Qxu, Urb, Ur, Urb, Urb, Ur, Ur, Xor, Cud^Xo, Xu, Xor, Xu
Xu, Xu, Xu, Xu, Xu, Xu, Xor, Xu, Xor, Xu, Ur, Ur, Urb, Urb, Ur, Ur, Cud, Qxu, Qxu, Qxu, Cud, Ur, Ur, Urb, Urb, Ur, Ur, Xu, Xu, Xor
Ur^Es, Ur, Qxu, Qxu, Xor, Urb, Ur, Xor, Xu, Xu, Ur, Urb, Ur, Ur, Xu, Cud^Eb, Cud, Cud, Qxu, Cud, Cud, Cud^Eb, Xu, Ur, Ur, Urb, Cud, Cud, Uu, Uu
Urb, Ur, Qxu, Xor, Xor, Cud^Eb, Xu, Cud, Cud, Cud, Ur, Urb, Ur, Xu, Xu, Qxu, Qxu, Qxu, Qxu, Qxu, Qxu, Qxu, Xu, Xor, Xor, Cud, Uu, Urb, Urb, Urb
Xor, Ur, Ur, Qxu, Qxu, Xu, Xu, Urb, Urb^Es, Ur, Urb, Urb, Qxu, Xu, Xu, Qxu, Qxu, Qxu, Qxu, Qxu, Qxu, Xu, Xu, Xu, Xu, Xu, Xor, Uu, Uu, Uu
Xor, Xor, Ur, Qxu, Ur, Qxu, Qxu, Cud, Cud, Cud^Es, Qxu, Qxu^Bcx\, Ur^Vud, Xu, Xor, Xor, Xor, Xu, Xu, Qxu, Qxu, Qxu, Xu, Xu, Xu, Xu, Xu, Xu, Xor, Xor
Ur^Ebn, Ur, Qxu, Qxu^Bcx\, Ur^Es, Xor, Qxu, Qxu, Qxu^Bcx|, Qxu, Qxu, Xor, Ur^Es, Ur, Qxu, Xor, Xu, Xu, Xu, Xu, Xu, Xu, Xu, Xu, Xu, Xu, Xu, Xu, Xu, Xu
Qxu, Qxu, Ur^Es, Ur, Urb, Ur, Qxu, Qxu, Urb, Qxu, Qxu, Ur, Urb, Ur, Ur, Qxu, Xu, Xu, Xu, Xu, Xu, Xu, Xu, Xu, Xu, Xu, Xu, Xu, Xu, Xu
Xor, Ur, Ur^Eb, Urb, 1 Ur, Ur, Qxu^Bcx/, Urb, Urb^Eb, Ur, Qxu, Ur, Xu, Cud^Xo, Xu, Xu, Xu, Xu, Xu, Xu, Xu, Xu, Xu, Xu, Xu, Xu, Xu, Xu, Xu, Xu
Xor, Xor, Ur^Es, Ur^Es, Urb, Urb, Qxu, Ur, Ur, Ur^Es, Xor, Xu, Xu, Xu, Xu, Xu, Xu, Xu, Xu, Xu, Xu, Xu, Xu, Xu, Xu, Xu, Xu, Xu, Xu, Xu
Xu, Xu, Ur^Es, Urb, Ur^Es, Qxu, Xu, Xu, Xu, Xu, Xu, Xu, Xu, Xu, Xu, Xu, Xu, Xu, Xu, Xu, Xu, Xu, Xu, Xu, Xu, Xu, Xu, Xu, Xu, Xu
Xu, Ur^Es, Urb, Urb, Ur, Xu, Xu, Xu, Xu, Xu, Xu, Xu, Xu, Xu, Xu, Xu, Xu, Xu, Xu, Xu, Xu, Xu, Xu, Xu, Xu, Xu, Xu, Xu, Xu, Xu
Xu, Ur^Es, Urb, Ur, Ur, Xu, Xu, Xu, Xu, Xu, Xu, Xu, Xu, Xu, Xu, Xu, Xu, Xu, Xu, Xu, Xu, Xu, Xu, Xu, Xu, Xu, Xu, Xu, Xu, Xu
