Aa^Fpa, Aa^Fpa, Aa^Fpa, Aa^Fpa, Ha, Ha, Ha, Hh, Ha, Ww, Hh, Hh, Hh, Hh, Hh^Qhh, Hh^Qhh, Mm^Qhh, Mm^Qhh, Mm^Qhh, Mm^Qhh, Ms^Qhh, Ms^Qhh, Ms^Qhh, Mm^Qhh, Ms^Qhh, Ms^Qhh, Ms^Qhh, Gg^Qhh, Ms^Qhh, Gg^Qhh, Ha^Qhh, Ha^Qhh, Ww, Mm, Mm^Xm, Xu, Xu, Xu, Cud, Cud, Cud, Cud
Aa^Fpa, Aa^Fpa, Aa^Fpa, Aa^Fpa, Ms, Ha^Esa, Ms^Xm, Ms^Xm, Ms^Xm, Ha^Esa, Mm, Hh, Hh, Hh^Es, Hh, Hh^Qhh, Hh^Qhh, Hh^Qhh, Hh^Qhh, Mm^Xm, Hh, Ms, Mm, Ms^Xm, Ms^Xm, Ms^_mhh, Ms^Xm, Ms^Xm, Ms^Xm, Ha^Es, Ha^Qhh, Ww, Ww, Mm^Xm, Mm^Xm, Xu, Xu, Tb^Tf, Uu, 2 Kud, Cud, Cud
Aa^Fpa, Aa^Fpa, Aa^Fpa, Aa^Fpa, Ms, Ms, Ms, Ms^Xm, Ms^Xm, Ms, Ms, Mm^Xm, Mm^Xm, Mm^Xm, Mm, Ms, Ms^Xm, Gs^Qhh, Ms^Xm, Hh^Qhh, Hh^Qhh, Hh^Qhhf, Hh^Qhhf, Ha^Fpa, Ha^Qhhf, Ha^Fpa, Hh^Qhh, Ms^Qhh, Ha^Qhh, Ha^Qhh, Ww, Ww, Mm, Mm^Xm, Hhd, Cud, Hhd, Uu, Xu, Xu, Xu, Xu
Hh^Fp, Aa^Fpa, Aa^Fpa, Aa^Fpa, Gs^Fp, Ha, Uu^Vud, Ha, Hh, Ms, Hh, Mm, Mm, Mm, Ms, Ms, Ms, Ms^Xm, Ms, Ms^Xm, Ms, Hh^Fp, Hh^Fp, Hh^Qhhf, Hh^Fp, Hh^Qhhf, Wwf, Ww, Ww, Wwf, Gs, Hh, Gs, Mm, Hhd, Hhd, Ha, Uu, Ms, Xu, Xu, Xu
Hh, Hh^Fp, Gs^Fp, Gs^Fp, Gg, Rb^Gvs, Re^Gvs, Rb^Gvs, Gs^Fp, Hh, Hh^Fp, Hh^Fp, Hh^Fp, Gs^Fp, Gs^Fp, Mm, Gs^Fp, Ms, Mm, Ms, Hhd, Md, Hhd, Hh^Fp, Ww, Wwf, Hh, Gg, Hh, Hh, Hh, Gs^Ebn, Hh, Hhd, Hhd, Gs, Ha, Ha, Hhd^Vud, Cud, Xu, Xu
Hh, Hh^Fp, Hh^Fp, Gg^Es, Gs^Dr, Gs^Fp, Re^Gvs, Re^Gvs, Mm, Mm^Xm, Mm, Gs^Fp, Hh^Fp, Hh^Fp, Hh^Fp, Hh^Fp, Hh^Fp, Hh, Gs^Fp, Gs, Gd, Gd^Dr, Ww, Ww, Mm, Hh, Mm^Xm, Hh, Hh, Mm, Mm^Xm, Cf^Qhh, Mm^Xm, Hhd, Hhd^Vud, Gd^Es, Gs, Gd^Ebn, Hhd, Ha, Ms^_mh, Xu
Hh, Hh^Fp, Gs^Fp, Gs^Fp, Gg^Es, Re^Gvs, Re^Gvs, Re^Gvs, Hh^Fp, Mm, Mm, Cfr^Dr, Kfr, Mm, Mm, Hh, Ha, Hh^Fp, Ha, Gs, Gd, Ww, Gs, Hh, Hh, Mm, Cf, Mm^Xm, Mm, Mm, Mm, Mm^Xm, Ms, Ms^Xm, Ms^Xm, Ms, Hhd, Gs, Hhd^Qhh, Aa^Qhh, Ha^Qhh, Ms^Qhh
Hh^Fp, Hh^Fp, Gs^Fp, Gg^Es, Hh^Fp, Gs^Fp, Hh^Fp, Rb^Gvs, Rb^Gvs, Hh^Fp, Uu^Vud, Cfr, Mm, Cfr, Mm, Mm, Ha, Hh^Fp, Hh^Fp, Gs^Fp, Gs^Fp, Wwf, Wwf, Hh^Es, Gs, Hh^Fp, Hh^Fp, Mm, Hhd, Mm, Mm, Mm, Mm, Ms^Xm, Ms, Ms^Xm, Ms, Ms, Ms^Qhh, Wo, Wo, Wo
Hh, Gs^Fp, Gg^Es, Gg^Es, Hh^Fp, Hh^Fp, Gs^Fp, Rb^Gvs, Re^Gvs, Rb^Gvs, Ha^Fma, Gs^Fp, Gs^Fp, Mm, Mm, Mm, Ha, Hh^Fp, Ha, Gs^Fp, Gs^Fp, Gs^Fp, Wwf, Ww, Ww, Hh^Fp, Gd, Hhd, Hhd, Hhd^Es, Hhd^Es, Hhd, Hh, Hh, Hhd^Qhh, Ms, Cf^Qhh, Ms^Qhh, Ww, Wo, Ha^Qhh, Ha^Qhh
Mm, Hh^Fp, Hh^Fp, Hh^Fp, Hh^Fp, Gs^Fp, Hh^Fp, Hh^Fp, Re^Gvs, Ha^Fma, Ha^Fma, Ha^Fma, Ha, Hh, Mm, Mm, Hh^Fp, Hh^Fp, Gs^Fp, Gs^Fp, Gs^Fp, Wwf, Wwf, Wwf, Hhd, Ww, Ww, Gd^Dr, Gd^Es, Hh, Gs^Qhh, Hh, Hh^Qhh, Gs^Qhh, Wo, Hh^Qhh, Wo, Ww, Hhd^Qhh, Ha^Qhh, Ha^_mhh, Hh^Qhh
Hh^Fp, Mm, Mm, Hh^Fp, Gs^Fp, Gs^Fp, Hh^Fp, Re^Gvs, Re^Gvs, Re^Gvs, Ha^Fma, Ha^Fma, Ha^Fma, Hh, Mm, Ha, Ha, Ha, Uu^Vud, Gs^Fp, Wwf, Wwf, Wwf, Md, Md, Ww, Ww, Wwf, Wwf, Gs^Qhh, Wwf, Gs^Qhh, Ww, Wo, Hh^Qhh, Wo, Ha^Qhh, Hhd^Qhh, Ha, Ha^Qhh, Ms, Ms^Qhh
Mm, Hh^Fp, Hh^Fp, Hh^Fp, Ha, Hh^Fp, Rb^Gvs, Re^Gvs, Rb^Gvs, Ha^Fma, Ha^Fma, Ha^Fma, Ha, Mm, Mm, Ms, Ms, Ms, Ms^Xm, Ha, Wwf, Wwf, Mm, Md, Hhd, Hhd, Ww, Ww, Ww, Ww, Gs^Qhh, Ww, Ww, Hh^Qhh, Gs^Dr, Hhd^Qhh, Rb, Ha, Ms^Qhh, Ms^Xm, Ms, Ms^Qhh
Mm, Mm, Mm, Ms, Ms, Cfr, Ms, Rb^Gvs, Ha^Fma, Ha^Fma, Ha^Fma, Ha^Fma, Hh, Mm, Mm, Mm, Ms^Xm, Ms, Ms^Xm, Ms, Mm, Mm, Mm, Md, Wwf, Wwf, Ww, Ww, Ww, Wwf, Ww, Ww, Ww, Hhd^Qhh, Hhd^Qhh, Hhd, Ha^Qhh, Ms, Ha, Ms^Qhh, Ms^Qhh, Ms^Qhh
Gg, Hh^Fp, Hh, Ms, Ms, Ms, Ha, Ms, Ms, Ha^Fma, Ha, Ha, Ha^Esa, Hh, Mm, Mm, Ms, Ms^Xm, Ms^Xm, Hh, Mm, Hh^Fp, Cfr, Mm, Mm, Wwf, Wwf, Wwf, Wwf, Ww, Gs^Qhh, Gs^Qhh, Ww, Ww, Hhd^Qhh, Hhd, Rb^Qhh, Ha^Qhh, Ha^Qhh, Ha, Ha, Ha^Qhh
Gg, Hh, Gg, Hh, Uu^Vud, Mm, Hh, Ha, Ha, Ms, Ms, Ha, Gg, Ha, Gg, Mm, Ms, Ms, Mm, Ms^Xm, Ms^Xm, Cfr^Dr, Kfr, Cfr, Hh^Fp, Mm, Gg, Ww, Hhd, Hh, Gs^Qhh, Ww, Ww, Hhd^Qhh, Hhd^Qhh, Rb^Qhh, Hhd, Hhd, Re^Dr, Ha^Qhh, Gg, Gg
Gg^Es, Gg, Gg, Hh, Re^Gvs, Re^Gvs, Re^Gvs, Hh^Es, Hh, Mm, Mm, Mm, Md, Hhd, Hhd, Uu^Vud, Md, Ms, Ms, Ms^Xm, Ms^Xm, Ms^Xm, Ms^Xm, Ms^Xm, Ms^Xm, Ha, Mm, Hhd, Uu^Vud, Gs^Qhh, Ww, Ww, Re^Gvs, Uu^Vud, Rb, Rb, Rb^Gvs, Re^Gvs, Re^Gvs, Re^Gvs, Re^Gvs, Re^Gvs
Hh^Fp, Gg, Gg, Rb^Gvs, Rb^Gvs, Rb^Gvs, Re^Gvs, Re^Gvs, Re^Gvs, Uu^Vud, Mm, Mm^Xm, Md^Xm, Md, Hhd, Hhd, Hhd, Md, Md, Hh, Hh, Mm, Mm, Mm^Qhh, Mm^Qhh, Ms^Qhh, Mm^Qhh, Mm, Hhd^Qhh, Re^Qhh, Ww, Ww, Rb^Gvs, Re^Gvs, Re^Gvs, Rb^Gvs, Rb^Gvs, Rb^Gvs, Rb^Gvs, Re^Gvs, Re^Gvs, Re^Gvs
Gs^Fp, Hh^Fp, Gs^Fp, Re^Gvs, Re^Gvs, Rb^Gvs, Re^Gvs, Re^Gvs, Gg, Hh, Mm, Mm^Xm, Mm, Md^Xm, Mm, Ww, Ww, Hh, Ww, Hh, Ww, Ww, Ww, Ww, Wwf, Wwf, Wwf, Mm^Qhh, Wwf, Hh^Qhh, Ww, Gs, Hhd^Es, Rb^Gvs, Hhd, Gs^Dr, Hhd, Rb^Gvs, Rb^Gvs, Rb^Gvs, Rb^Gvs, Rb^Gvs
Gs^Fp, Gs^Fp, Hh^Fp, Gs^Fp, Gs, Gg, Ss, Gg, Ww, Ww, Ww, Mm, Ww, Mm, Wwf, Ww, Mm, Ww, Hh, Ww, Hhd, Ww, Uu^Vud, Re^Gvs, Rb^Gvs, Wwf, Hh, Ww, Ww, Ww, Rb^Gvs, Rb^Gvs, Gs^Dr, Hhd, Hhd, Hhd, Hh^Es, Gs, Hh, Rb^Gvs, Rb^Gvs, Rb^Gvs
Mm, Hh^Fp, Hh^Fp, Gs^Fp, Gs, Gs, Ss, Ww, Hh^Fp, Hh^Fp, Hh^Fp, Ww, Hh^Fp, Wwf, Hh^Fp, Hh^Fp, Hh, Mm, Hh^Es, Hh, Mm, Hhd, Hh^Fp, Rb^Gvs, Hh^Fp, Hh, Mm, Mm, Hh, Rb^Gvs, Rb^Gvs, Re^Gvs, Hh, Hh, Hh, Md, Md, Hh, Hh, Hh, Hh, Hh
Mm, Mm, Mm, Hh, Gg, Ss, Ss, Wwf, Gs^Fp, Hh^Fp, Gs^Fp, Hh^Fp, Gs^Fp, Hh^Fp, Gs^Fp, Hh^Fp, Rb^Gvs, Hh, Hh, Hh, Mm, Mm, Mm, Hh^Fp, Gs^Fp, Hh, Mm, Mm^Xm, Mm, Hh^Vct, Hh^Es, Rb^Gvs, Rb^Gvs, Hh, Rb^Gvs, Hh, Hh^Vct, Hh, Md, Hh^Es, Hh, Hh
Mm, Mm, Mm, Hh, Hh, Ss, Ww, Ww, Ss, Gs^Fp, Gs^Fp, Gs^Fp, Gg, Gs^Fp, Rb^Gvs, Re^Gvs, Re^Gvs, Rb^Gvs, Hh, Hh, Mm, Cfr, Hh^Fp, Mm, Mm, Mm, Hh, Mm, Mm, Hh, Gg, Gg, Hh, Rb^Gvs, Rb^Gvs, Re^Gvs, Re^Gvs, Hh, Md, Md, Mm, Mm
Hh^Fp, Hh, Hh, Hh, Hh, Gg, Ww, Ss, Gg, Gg, Re^Es, Re, Rb, Gg, Gg, Re^Gvs, Gs^Fp, Uu^Vud, Gs^Fp, Hh, Hh, Mm, Mm, Mm, Mm^Xm, Mm, Mm, Hh, Hh^Fp, Mm, Mm, Hh, Cfr^Dr, Cfr, Hh, Re^Gvs, Gs^Es, Hh, Hh, Md, Gg, Gg
Gs^Fp, Gg, Gg^Es, Gg, Gs, Gg, Ww, Ss, Re, Gg, Gg, Gg, Gs^Fp, Gs^Fp, Gs^Fp, Gs^Fp, Gs^Fp, Gs^Fp, Gs^Fp, Gs^Fp, Gg, Hh^Fp, Hh, Mm, Mm, Mm^Xm, Mm^Xm, Hh^Fp, Hh^Fp, Hh, Hh, Mm, Mm, Kfr, Cfr, Hh^Dr, Hh, Gg, Gs^Fp, Hh, Hh, Hh
Gs^Fp, Gs^Fp, Gs, Gg, Gs, Wwf, Gg, Gg, 1 Re, Re, Re^Vhr, Gs^Fp, Gs^Fp, Gs^Fp, Gs^Fp, Gs^Fp, Gs^Fp, Gs^Fp, Gs^Fp, Gs^Fp, Gg, Hh, Hh, Hh^Es, Hh, Mm^Xm, Hh, Mm, Hh^Fp, Gs^Fp, Gg, Hh^Gvs, Mm, Mm, Mm, Mm, Mm, Hh, Mm, Gs^Fp, Gs^Fp, Gs^Fp
Gs^Fp, Gs^Fp, Gs, Gs^Es, Wwf, Wwf, Wwf, Rb, Re, Gg, Gg, Gs^Fp, Gs^Fp, Gs^Fp, Hh^Fp, Hh^Fp, Hh^Fp, Hh^Fp, Hh^Fp, Gs^Fp, Gg, Gs, Gs, Gg, Gs, Hh, Gg, Hh, Hh, Hh^Fp, Hh^Fp, Hh^Gvs, Hh^Gvs, Hh, Hh^Es, Hh^Vct, Hh, Mm, Mm, Mm^Xm, Mm^Xm, Mm^Xm
Gg, Gg, Ww, Ww, Gs^Fp, Gg, Ww, Gg, Gg, Gg, Gg, Gs^Fp, Gg, Gs^Fp, Hh, Hh, Hh, Hh^Fp, Hh, Hh, Hh, Gs, Gg, Hh, Hh, Gg, Gg, Hh, Hh, Gs^Fp, Hh^Fp, Hh^Fp, Hh^Fp, Hh, Hh, Hh, Hh, Hh, Hh, Mm^Xm, Hh, Hh
Gg, Gg, Ww, Gs^Fp, Gs^Fp, Ww, Ce, Ce, Gg, Gg, Gg, Gg, Gs^Fp, Gg, Gg, Hh, Hh, Hh, Hh, Hh, Gg, Gg, Gg, Hh, Hh^Qhux, Hh, Hh^Qhux, Gg, Gg^Fp, Gg^Fp, Gg^Fp, Hh^Fp, Gg^Fp, Gg, Gg, Hh, Hh, Hh, Hh, Hh, Hh, Hh
Gg, Ww, Gs^Fp, Gs^Fp, Wwf, Ww, Gg, Ke, Ce, Gg, Gs^Fp, Gg, Gs^Fp, Gs^Fp, Gs^Fp, Re^Vhr, Gg, Gs^Fp, Gs^Fp, Gg, Hh, Hh, Hh^Qhux, Hh^Qhux, Mm, Hh^Qhux, Mm^_ml, Hh^Qhux, Hh^Qhux, Gg^Qhux, Hh^Qhux, Gg, Gg, Gg, Gg, Hh, Hh, Hh, Hh, Hh, Hh, Hh
Ww, Ww, Wwf, Wwf, Gg, Gg, Gg, Ce, Gg, Gg, Gs^Fp, Gs^Fp, Gs^Fp, Gs^Fp, Gs^Fp, Gs^Fp, Gg, Gs^Fp, Hh^Qhux, Gs^Fp, Hh^Qhux, Hh^Qhux, Mm, Mm, Mm, Mm, Mm, Mm, Mm, Hh^Qhux, Hh^Qhux, Hh, Hh, Gg, Gg, Gg, Gg, Hh, Hh, Hh, Hh, Hh
