Aa^Fpa, Aa^Fpa, Aa^Fpa, Aa^Fpa, Ha, Ha, Ha, Hh, Ha, Ww, Hh, Hh, Hh, Hh, Ha^Qhh, Ms^Qhh, Ms^Qhh, Mm^Qhh, Mm^Qhh, Mm^Qhh, Ms^Qhh, Ms^Qhh, Ms^Qhh, Mm^Qhh, Ms^Qhh, Ms^Qhh, Ms^Qhh, Gg^Qhh, Ms^Qhh, Gg^Qhh, Ha^Qhh, Ha^Qhh, Ww, Mm, Mm^Xm, Xu, Xu, Xu, Cud, Cud, Cud, Cud
Aa^Fpa, Aa^Fpa, Aa^Fpa, Aa^Fpa, Ms, Ha^Esa, Ms^Xm, Ms^Xm, Ms^Xm, Ha^Esa, Mm, Hh, Hh, Ha^Es, Ha, Ha^Qhh, Ha^Qhh, Ha^Qhh, Hh^Qhh, Mm^Xm, Hh, Ms, Mm, Ms^Xm, Ms^Xm, Ms^_mhh, Ms^Xm, Ms^Xm, Ms^Xm, Ha^Es, Ha^Qhh, Ww, Ww, Mm^Xm, Mm^Xm, Xu, Xu, Tb^Tf, Uu, 2 Kud, Cud, Tb^Tf
Aa^Fpa, Aa^Fpa, Aa^Fpa, Aa^Fpa, Ms, Ms, Ms, Ms^Xm, Ms^Xm, Ms, Ms, Mm^Xm, Mm^Xm, Mm^Xm, Mm, Ms, Ms^Xm, Gs^Qhh, Ms^Xm, Hh^Qhh, Hh^Qhh, Hh^Qhhf, Hh^Qhhf, Ha^Fpa, Ha^Qhhf, Ha^Fpa, Hh^Qhh, Ms^Qhh, Ha^Qhh, Ha^Qhh, Ww, Ww, Mm, Mm^Xm, Hhd, Cud, Hhd, Uu, Xu, Uu, Xu, Xu
Hh^Fp, Aa^Fpa, Aa^Fpa, Aa^Fpa, Gs^Fp, Ha, Uu^Vud, Ha, Hh, Ms, Hh, Mm, Mm, Mm, Ms, Ms, Ms, Ms^Xm, Ms, Ms^Xm, Ms, Hh^Fp, Hh^Fp, Hh^Qhhf, Hh^Fp, Hh^Qhhf, Wwf, Ww, Ww, Wwf, Gs, Hh, Gs, Mm, Hhd, Hhd, Ha, Uu, Xu, Xu, Xu, Xu
Hh, Hh^Fp, Gs^Fp, Gs^Fp, Gg, Rb^Gvs, Re^Gvs, Rb^Gvs, Gs^Fp, Hh, Hh^Fp, Hh^Fp, Hh^Fp, Gs^Fp, Gs^Fp, Mm, Gs^Fp, Ms, Mm, Ms, Hhd, Md, Hhd, Hh^Fp, Ww, Wwf, Hh, Gg, Hh, Hh, Hh, Gs^Ebn, Hh, Hhd, Hhd, Gs, Ha, Ha, Hhd^Vud, Cud, Xu, Xu
Hh, Hh^Fp, Hh^Fp, Gg^Es, Gs^Dr, Gs^Fp, Re^Gvs, Re^Gvs, Mm, Mm^Xm, Mm, Gs^Fp, Hh^Fp, Hh^Fp, Hh^Fp, Hh^Fp, Hh^Fp, Hh, Gs^Fp, Gs, Gd, Gd^Dr, Ww, Ww, Mm, Hh, Mm^Xm, Hh, Hh, Mm, Mm, Cf^Qhh, Mm^Xm, Hhd, Hhd^Vud, Gd^Es, Gs, Gd^Ebn, Hhd, Ha, Ms^_mh, Xu
Hh, Hh^Fp, Gs^Fp, Gs^Fp, Gg^Es, Re^Gvs, Re^Gvs, Re^Gvs, Hh^Fp, Mm, Mm, Cfr^Dr, 4 Kfr, Mm, Mm, Hh, Ha, Hh^Fp, Cfr, Gs, Gd, Ww, Gs, Hh, Hh, Mm, Cf, Mm^Xm, Mm, Mm^Xm, Mm, Mm^Xm, Ms, Ms^Xm, Ms^Xm, Ms, Hhd, Gs, Hhd^Qhh, Aa^Qhh, Ha^Qhh, Ms^Qhh
Hh^Fp, Hh^Fp, Gs^Fp, Gg, Hh^Fp, Gs^Fp, Hh^Fp, Rb^Gvs, Rb^Gvs, Hh^Fp, Uu^Vud, Cfr, Mm, Cfr, Mm, Ms, Ha, Hh^Fp, Hh^Fp, Gs^Fp, Hh^Fp, Wwf, Wwf, Hh^Es, Gs, Hh^Fp, Hh^Fp, Md, Hhd, Mm, Md, Mm, Mm, Ms^Xm, Ms, Ms^Xm, Ms, Ms, Ms^Qhh, Wo, Wo, Wo
Hh, Gs^Fp, Gg^Es, Gg^Es, Hh^Fp, Hh^Fp, Gs^Fp, Rb^Gvs, Re^Gvs, Rb^Gvs, Hh, Gs^Fp, Gs^Fp, Mm, Mm, Ms, Ha, Hh^Fp, Ha, Gs^Fp, Hh^Fp, Hh^Fp, Wwf, Ww, Ww, Hh^Fp, Gd, Hhd, Hhd, Hhd^Es, Hhd^Es, Hhd, Hh, Hh, Hhd^Qhh, Ms, Cf^Qhh, Ms^Qhh, Ww, Wo, Ha^Qhh, Ha^Qhh
Mm, Hh^Fp, Hh^Fp, Hh^Fp, Hh^Fp, Gs^Fp, Hh^Fp, Hh^Fp, Re^Gvs, Hh, Hh, Hh, Ha, Hh, Mm, Mm, Hh^Fp, Hh^Fp, Gs^Fp, Gs^Fp, Gs^Fp, Wwf, Ww, Wwf, Hhd, Wwf, Wwf, Gd^Dr, Gd^Es, Hh, Gs^Qhh, Hh, Hh^Qhh, Gs^Qhh, Wo, Hh^Qhh, Wo, Ww, Hhd^Qhh, Ha^Qhh, Ha^_mhh, Hh^Qhh
Hh^Fp, Mm, Mm, Hh^Fp, Gs^Fp, Gs^Fp, Hh^Fp, Re^Gvs, Re^Gvs, Re^Dr, Hh, Ha^Fma, Ha^Fma, Hhd^Vhhr, Mm, Ha, Ha, Ha, Uu^Vud, Gs^Fp, Wwf, Wwf, Ww, Md, Md, Ww, Ww, Wwf, Wwf, Gs^Qhh, Wwf, Gs^Qhh, Ww, Wo, Hh^Qhh, Wo, Ha^Qhh, Hhd^Qhh, Ha, Ha^Qhh, Ms, Ms^Qhh
Mm, Hh^Fp, Hh^Fp, Hh^Fp, Ha, Hh^Fp, Rb^Gvs, Re^Gvs, Rb^Gvs, Ha^Fma, Ha^Fma, Ha^Fma, Ha, Mm, Mm, Ms, Ms, Ms^Xm, Ms^Xm, Ha, Wwf, Wwf, Mm, Md, Hhd, Hhd, Ww, Ww, Ww, Ww, Gs^Qhh, Ww, Ww, Hh^Qhh, Gs^Dr, Hhd^Qhh, Rb, Ha, Ms^Qhh, Ms^Xm, Ms^Xm, Ms^Xm
Mm, Mm, Mm, Ms, Ms, Cfr^Dr, Hh, Rb^Gvs, Ha^Fma, Ha^Fma, Ha^Fma, Ha^Fma, Hh, Mm, Mm, Mm, Ms^Xm, Ms^Vaa, Ms^Xm, Ms, Mm, Mm, Mm, Md, Wwf, Wwf^Dr, Ww, Ww, Ww, Wwf, Ww, Ww, Ww, Hhd^Qhh, Hhd^Qhh, Hhd, Ha^Qhh, Ms, Ha, Ms^Qhh, Ms^Qhh, Ms^Qhh
Hh, Hh^Fp, Hh, Ms, Ms, Ms, Mm, Hh, Mm, Ha^Fma, Ha, Ha^Vca, Ha^Esa, Hh, Mm, Mm, Ms, Ms^Xm, Ms^Xm, Hh, Mm, Hh^Fp, Cfr, Mm, Mm, Wwf, Wwf, Wwf, Wwf, Ww, Gs^Qhh, Gs^Qhh, Ww, Ww, Hhd^Qhh, Hhd, Rb^Qhh, Ha^Qhh, Ha^Qhh, Ha, Ha, Ha^Qhh
Gg, Hh, Gg, Mm, Hh^Vhhr, Mm, Hh, Mm, Ha, Ms, Ms, Ha, Gs, Ha, Cfr, Mm, Ms, Ms, Mm, Ms^Xm, Ms^Xm, Cfr^Dr, 3 Kfr, Cfr, Cfr, Mm, Gd, Ww^Dr, Hhd, Hh, Gs^Qhh, Ww, Ww, Hhd^Qhh, Hhd^Qhh, Rb^Qhh, Hhd, Hhd, Re^Dr, Ha^Qhh, Gg, Gg
Gg^Es, Gg, Gg, Hh, Re^Gvs, Re^Gvs, Re^Gvs, Hh^Es, Hh, Mm, Mm, Mm, Md, Hhd, Hhd, Hhd^Vhhr, Md, Ms, 5 Kfr, Ms^Xm, Ms^Xm, Ms^Xm, Ms^Xm, Ms^Xm, Ms^Xm, Ha, Mm, Hhd, Uu^Vud, Gs^Qhh, Ww, Ww, Re^Gvs, Uu^Vud, Rb, Rb, Rb^Gvs, Re^Gvs, Re^Gvs, Re^Gvs, Re^Gvs, Re^Gvs
Hh^Fp, Gg, Gg, Rb^Gvs, Rb^Gvs, Rb^Gvs, Re^Gvs, Re^Gvs, Re^Gvs, Uu^Vud, Mm, Mm, Md^Xm, Md, Hhd, Hhd, Hhd, Cfr^Dr, Cfr, Mm, Hh, Mm, Mm, Mm^Qhh, Mm^Qhh, Ms^Qhh, Mm^Qhh, Mm, Hhd^Qhh, Re^Qhh, Ww, Ww, Rb^Gvs, Re^Gvs, Re^Gvs, Rb^Gvs, Rb^Gvs, Rb^Gvs, Rb^Gvs, Re^Gvs, Re^Gvs, Re^Gvs
Gs^Fp, Hh^Fp, Gs^Fp, Re^Gvs, Re^Gvs, Rb^Gvs, Re^Gvs, Re^Gvs, Gg, Hh, Mm, Mm^Xm, Mm, Md^Xm, Mm, Ww, Ww, Hh, Ww, Hh, Wwf, Wwf, Wwf, Ww, Ww, Ww, Ww, Mm^Qhh, Wwf, Hh^Qhh, Wwf, Gs, Hhd^Es, Rb^Gvs, Hhd, Gs^Dr, Hhd, Rb^Gvs, Rb^Gvs, Rb^Gvs, Rb^Gvs, Rb^Gvs
Gs^Fp, Gs^Fp, Hh^Fp, Gs^Fp, Gs, Gg, Ss, Gg, Ww, Ww, Ww, Mm, Ww, Mm, Ww, Ww, Mm, Ww, Hh^Vhh, Ww, Hhd, Wwf, Uu^Vud, Re^Gvs, Rb^Gvs, Ww, Hh, Ww, Wwf, Wwf, Rb^Gvs, Rb^Gvs, Gs^Dr, Hhd, Hhd, Hhd, Hh^Es, Gs, Hh, Rb^Gvs, Rb^Gvs, Rb^Gvs
Mm, Hh^Fp, Hh^Fp, Gs^Fp, Gs, Gs, Ss, Ww, Hh^Fp, Hh^Fp, Hh^Fp, Ww, Hh^Fp, Ww, Hh^Fp, Hh^Fp, Hh, Mm, Hh^Es, Hh, Mm, Hhd, Hh^Fp, Rb^Gvs, Hh^Fp, Hh, Mm, Mm, Hh, Rb^Gvs, Rb^Gvs, Re^Gvs, Hh, Hh, Hh, Md, Md, Hh, Hh, Hh, Hh, Hh
Mm, Mm, Mm, Hh, Gg, Ss, Ss^Vhs, Wwf, Gs^Fp, Hh^Fp, Gs^Fp, Hh^Fp, Gs^Fp, Hh^Fp, Gs^Fp, Hh^Fp, Rb^Gvs, Hh, Hh, Hh, Mm, Mm, Mm, Hh^Fp, Gs^Fp, Hh, Mm, Mm^Xm, Mm, Hh^Vhhr, Hh^Es, Rb^Gvs, Rb^Gvs, Hh, Rb^Gvs, Hh, Uu^Vud, Hh, Md, Hh^Es, Hh, Hh
Mm, Mm, Mm, Hh, Hh, Ss, Ww, Ww, Ss, Gs^Fp, Gs^Fp, Gs^Fp, Gg, Gs^Fp, Rb^Gvs, Re^Gvs, Re^Gvs, Rb^Gvs, Hh, Hh, Mm, Cfr, Hh^Fp, Mm, Mm, Mm, Hh, Mm, Mm, Hh, Gg, Gg, Hh, Rb^Gvs, Rb^Gvs, Re^Gvs, Hh, Hh, Md, Md, Mm, Mm
Hh^Fp, Hh, Hh, Hh, Hh, Gg, Ww, Ss, Gg^Vhr, Gg, Re^Es, Re, Rb, Gg, Ss, Re^Gvs, Ss^Em, Re^Vhr, Gs, Hh, Hh, Mm, Mm, Mm, Mm^Xm, Mm, Mm, Hh^Vhhr, Hh^Fp, Mm, Mm, Hh, Cfr^Dr, Cfr, Hh, Re^Gvs, Gs^Es, Hh, Hh, Md, Gs, Gs^Es
Gs^Fp, Gg, Gg^Es, Gg, Gs, Gg, Ww, Ss, Re, Gg, Gg, Gg, Gs^Fp, Gs^Fp, Gs^Fp, Ss, Ss^Em, Ss, Gs, Gs, Gs, Hh^Fp, Hh, Mm, Mm, Mm^Xm, Mm, Hh^Fp, Hh^Fp, Hh, Hh, Mm, Mm, 6 Kfr, Cfr, Hh^Dr, Hh, Gg, Gs^Fp, Hh, Hh, Hh
Gs^Fp, Gs^Fp, Gs, Gg, Re^Vhr, Wwf, Gg, Gg, Re, Re, Re^Vhr, Gs^Fp, Gs^Fp, Gs^Fp, Gs^Fp, Gs^Fp, Gs^Fp, Ss^Emf, Ss, Ss^Em, Gg, Hh, Hh, Hh^Es, Hh, Mm, Hh, Mm, Hh^Fp, Gs^Fp, Gg, Hh^Gvs, Mm, Mm, Mm, Mm, Mm, Hh, Mm, Gs^Fp, Gs^Fp, Gs^Fp
Gs^Fp, Gs^Fp, Gs, Gs^Es, Wwf, Wwf, Wwf, Rb, Re, Gg, Gg, Gs^Fp, Gs^Fp, Gs^Fp, Hh^Fp, Hh^Fp, Ss^Vhs, Ss, Ss^Em, Ss, Ss, Ss, Ss, Gg, Gs, Hh, Ss, Hh, Hh, Hh^Fp, Hh^Fp, Hh^Gvs, Hh^Gvs, Hh, Hh^Es, Hh^Vhhr, Hh, Mm, Mm, Mm^Xm, Mm^Xm, Mm^Xm
Gg, Gs, Ww, Ww, Gs^Fp, Gg, Ww, Gg, Gg, Gg^Efm, Gg^Efm, Gs^Fp, Gg, Gs^Fp, Hh, Mm, Mm, Ss, Hh, Ss, Gg, Ss^Em, Ss^Em, Hh, Hh, Ss, Ss^Em, Hh, Hh, Gs^Fp, Hh^Fp, Hh^Fp, Hh^Fp, Hh, Hh, Hh, Hh, Hh, Hh, Mm^Xm, Hh, Hh
Gg, Gs^Vhh, Ww, Gs^Fp, Gs^Fp, Ww, Ce, Ce, Gg, Ce, Gs^Efm, Gg, Gs^Fp, Gs, Gs, Hh, Hh, Hh, Hh, Hh, Gg, Ss^Em, Ss, Hh, Hh^Qhux, Hh, Hh^Qhux, Ss, Gg^Fp, Gg^Fp, Gg^Fp, Hh^Fp, Gg^Fp, Gg, Gg, Hh, Hh, Hh, Hh, Hh, Hh, Hh
Gg, Ww, Gs^Fp, Gs^Fp, Wwf, Ww, Ce, 1 Ke, Ce, Gs, Gs^Fp, Gs^Vl, Gs^Fp, Gs^Fp, Gs^Fp, Gs^Vhh, Gs, Gs^Fp, Gs^Fp, Gg, Hh, Hh, Hh^Qhux, Hh^Qhux, Mm, Hh^Qhux, Mm^_ml, Hh^Qhux, Hh^Qhux, Gg^Qhux, Hh^Qhux, Gg, Gg, Gg, Gg, Hh, Hh, Hh, Hh, Hh, Hh, Hh
Ww, Ww, Wwf, Wwf, Gg, Rb, Re, Gg, Gs, Gs, Hh^Fp, Hh^Fp, Hh^Fp, Hh^Fp, Hh^Fp, Gs^Fp, Gs, Gs^Fp, Hh^Qhux, Gs^Fp, Hh^Qhux, Hh^Qhux, Mm, Mm, Mm, Mm, Mm, Mm, Mm, Hh^Qhux, Hh^Qhux, Hh, Hh, Gg, Gg, Gg, Gg, Hh, Hh, Hh, Hh, Hh
