Xu, Xu, Xu, Xu, Xu, Xu, Xu, Xu, Xu, Xu, Xu, Xu, Xu, Xu, Xu, Xu, Xu, Xu, Xu, Xu, Xu, Xu, Xu, Xu, Xu, Xu, Xu, Xu, Xu, Xu, Xu, Xu, Xu, Xu, Xu, Xu, Xu, Xu, Xu, Xu, Xu, Xu, Xu, Xu, Xu, Xu, Xu, Xu, Xu, Xu, Xu, Xu, Xu, Xu, Xu, Xu, Xu, Xu, Xu, Xu, Xu, Xu
Xu, Xu, Xu, Xu, Xu, Xu, Xu, Xu, Xu, Xu, Xu, Xu, Xu, Xu, Xu, Xu, Xu, Xu, Xu, Xu, Xu, Xu, Xu, Xu, Xu, Xu, Xu, Xu, Xu, Xu, Xu, Xu, Xu, Xu, Xu, Xu, Xu, Xu, Xu, Xu, Xu, Xu, Xu, Xu, Xu, Xu, Xu, Xu, Xu, Xu, Xu, Xu, Xu, Xu, Xu, Xu, Xu, Xu, Xu, Xu, Xu, Xu
Xu, Xu, Xu, Xu, Xu, Xu, Xu, Xu, Xu, Xu, Xu, Xu, Xu, Xu, Xu, Xu, Xu, Xu, Xu, Xu, Xu, Xu, Xu, Xu, Xu, Xu, Xu, Xu, Xu, Xu, Xu, Xu, Xu, Xu, Xu, Xu, Xu, Xu, Xu, Xu, Xu, Xu, Xu, Xu, Xu, Xu, Xu, Xu, Xu, Xu, Xu, Xu, Xu, Xu, Xu, Xu, Xu, Xu, Xu, Xu, Xu, Xu
Xu, Xu, Xu, Xu, Xu, Xu, Xu, Xu, Xu, Xu, Xu, Xu, Xu, Xu, Xu, Xu, Xu, Xu, Xu, Xu, Xu, Xu, Xu, Xu, Xu, Xu, Xu, Xu, Xu, Xu, Xu, Xu, Xu, Xu, Wwg^Es, Ur^Es, Ur^Ebn, Xu, Wwg^Es, Xu, Ss^Emf, Ss^Vhs, Xu, Xu, Xu, Xu, Xu, Xu, Xu, Xu, Xu, Xu, Xu, Xu, Xu, Xu, Xu, Xu, Xu, Xu, Xu, Xu
Xu, Xu, Xu, Xu, Xu, Xu, Xu, Xu, Xu, Xu, Xu, Xu, Xu, Xu, Xu, Xu, Xu, Xu, Xu, Xu, Xu, Xu, Xu, Xu, Xu, Xu, Xu, Xu, Xu, Xu, Xu, Uu^Vud, Rb^Em, Wwg^Es, Wwg, Uu, Uh^Qhh, Ur^Es, Ur, Wwg^Em, Sm^Qhu, Ss^Em, Xu, Xu, Xu, Xu, Xu, Xu, Xu, Xu, Xu, Xu, Xu, Xu, Xu, Xu, Xu, Xu, Xu, Xu, Xu, Xu
Xu, Xu, Xu, Xu, Xu, Xu, Xu, Xu, Xu, Xu, Xu, Xu, Xu, Xu, Xu, Xu, Xu, Xu, Xu, Ur^Vud, Ur^Edb, Xu, Xu, Xu, Xu, Ur^Edb, Xu, Xu, Xu, Xu, Xu, Xu, Sm^Emf, Rb^Em, Uue^Qhu, Uu, Cud, Cud, Cud, Rb, Rb^Es, Rb^Es, Ur^Es, Xu, Xu, Xu, Ur, Xu, Xu, Xu, Xu, Xu, Xu, Xu, Xu, Xu, Xu, Xu, Xu, Xu, Xu, Xu
Xu, Xu, Xu, Xu, Xu, Xu, Xu, Xu, Xu, Xu, Xu, Xu, Xu, Xu, Xu, Xu, Xu, Xu, Xu, Xu, Ur^Edb, Xu, Xu, Xu, Ur^Pr\o, Ur^Edb, Xu, Xu, Xu, Xu, Xu, Xu, Sm^Emf, Uue^Qhu, Uue^Qhu, Rb^Es, Cud, 4 Kud, Cud, Rb^Es, Rb^Em, Uu^Ebn, Xu, Ur^Pr/, Ur, Ur, Urb^Ii, Ur, Xu, Xu, Xu, Xu, Xu, Xu, Xu, Xu, Xu, Xu, Xu, Xu, Xu, Xu
Xu, Xu, Xu, Xu, Xu, Xu, Xu, Xu, Xu, Xu, Xu, Xu, Xu, Xu, Xu, Xu, Xu, Xu, Xu, Xu, Xu, Uu^Pr/o, Uu^Em, Uu^Es, Uh^Qhh, Xu, Xu, Xu, Xu, Xu, Xu, Xu, Xu, Uue^Qhu, Rb^Es, Rb, Rb, Cud, Sm^Bw\r, Sm^Qhu, Sm^Qhu, Xu, Xu, Xu, Xu, Ur, Ur, Ur, Xu, Xu, Xu, Xu, Xu, Xu, Xu, Xu, Xu, Xu, Xu, Xu, Xu, Xu
Xu, Xu, Xu, Xu, Xu, Xu, Xu, Xu, Xu, Xu, Xu, Xu, Xu, Xu, Xu, Xu, Xu, Xu, Xu, Xu, Uu^Pr\o, Uue^Qhu, Uh^Em, Uh^Emf, Uh^Tf, Xu, Xu, Xu, Xu, Xu, Xu, Xu, Uu^Em, Rb, Ur, Rb, Rb, Sm^Qhu, Wwg, Sm^Bw\r, Uh^Emf, Xu, Xu, Xu, Xu, Xu, Xu, Xu, Xu, Xu, Xu, Xu, Xu, Xu, Xu, Xu, Xu, Xu, Xu, Xu, Xu, Xu
Xu, Xu, Xu, Xu, Xu, Xu, Xu, Xu, Xu, Xu, Xu, Xu, Xu, Xu, Xu, Xu, Xu, Xu, Xu, Ur^Edb, Xu, Xu, Xu, Uh^Emf, Uh^Qhh, Uh^Emf, Xu, Xu, Xu, Xu, Xu, Uu^Emf, Ur^Es, Ur, Sm^Qhu, Sm^Qhu, Rb^Em, Wwg^Em, Wwg^Em, Uue^Emf, Xu, Uh^Vud, Xu, Xu, Xu, Xu, Xu, Xu, Xu, Xu, Xu, Xu, Xu, Xu, Xu, Xu, Xu, Xu, Xu, Xu, Xu, Xu
Xu, Xu, Xu, Xu, Xu, Xu, Xu, Xu, Xu, Xu, Xu, Xu, Xu, Xu, Xu, Xu, Xu, Uh^Em, Ur^Edb, Ur^Edb, Xu, Xu, Xu, Xu, Uue^Qhu, Xu, Xu, Xu, Xu, Xu, Uu, Uue^Qhu, Rb^Es, Ur, Uue^Qhu, Uu^Ebn, Sm^Em, Uh^Emf, Uh^Tf, Xu, Xu, Xu, Xu, Xu, Xu, Xu, Xu, Xu, Xu, Xu, Xu, Xu, Xu, Xu, Xu, Xu, Xu, Xu, Xu, Xu, Xu, Xu
Xu, Xu, Xu, Xu, Xu, Xu, Xu, Xu, Xu, Xu, Xu, Xu, Xu, Xu, Xu, Xu, Xu, Uh^Qhh, Ur^Edb, Xu, Xu, Xu, Uh^Vud, Xu, Uu^Es, Xu, Uh^Emf, Xu, Xu, Xu, Cud, Uu, Rb, Uue^Qhu, Xu, Xu, Xu, Uh^Tf, Uue^Em, Ur^Br\, Ur^Br\, Xu, Xu, Xu, Xu, Xom, Xom, Xu, Wwg^Em, Wwg^Emf, Xu, Xu, Xu, Xu, Xu, Xu, Xu, Xu, Xu, Xu, Xu, Xu
Xu, Xu, Xu, Xu, Xu, Xu, Xu, Xu, Xu, Xu, Xu, Xu, Xu, Xu, Xu, Xu, Xu, Xu, Xu, Xu, Xu, Xu, Uu^Emf, Uh^Tf, Uu^Em, Uu^Em, Uue^Qhu, Uu^Eb, Xu, Xu, Sm^Qhu, Rb, Ur^Es, Cud, Xu, Xu, Xu, Xu, Sm^Qhu, Sm^Qhu, Wwg^Es, Ur^Br\, Ur^Br\, Xom, Xom, Xom, Ur^Br/, Ur^Br/, Xom, Sm^Tf, Uh^Qhh, Xu, Xu, Xu, Xu, Xu, Xu, Xu, Xu, Xu, Xu, Xu
Xu, Xu, Xu, Xu, Xu, Xu, Xu, Xu, Xu, Xu, Xu, Xu, Xu, Xu, Xu, Xu, Xu, Xu, Xu, Xu, Uu^Eb, Uh^Em, Xu, Xu, Uu^Es, Xom, Uue^Qhu, Uue^Qhu, Uu^Pw/o, Xu, Sm^Qhu, Sm^Qhu, Ur, Xu, Xu, Xu, Xu, Xu, Ss^Em, Sm^Qhu, Xom, Wwg^Ewl, Wwg^Em, Ur^Br\, Ur^Br/, Ur^Br/, Wwg, Ur^Br\, Wwg, Xom, Sm^Tf, Uh^Qhh, Xu, Xu, Xu, Xu, Xu, Xu, Xu, Xu, Xu, Xu
Xu, Xu, Xu, Xu, Xu, Xu, Xu, Xu, Xu, Xu, Xu, Xu, Xu, Xu, Xu, Xu, Xu, Xu, Xu, Xu, Uh^Emf, Uh^Tf, Uu^Emf, Uu^Em, Xom, Xom, Uu^Pw\o, Xom, Xom, Uu, Uu, Ur, Rb, Ss^Emf, Xu, Xu, Xu, Ss^Ebn, Uue^Ebn, Xom, Xu, Xom, Wwg^Emf, Ur^Br|, Xom, Xom, Xom, Wwg, Sm^Dr, Wwg, Uh^Vud, Xu, Xu, Xu, Xu, Xu, Xu, Xu, Xu, Xu, Xu, Xu
Xu, Xu, Xu, Xu, Xos^Efs, Xos, Xos, Xu, Xos, Xu, Xu, Xu, Xu, Xu, Xos, Xu, Xu, Xu, Xu, Xu, Xu, Uh^Em, Xu, Uue^Qhu, Xom, Ur^Es, Ur^Es, Xom, Uh^Qhh, Uh^Qhh, Uh^Qhh, Ur^Es, Wwg, Ss^Emf, Ss^Tf, Xu, Xu, Xu, Xu, Xu, Xu, Ss^Tf, Ss^Emf, Sm^Qhu, Xom, Xu, Xu, Xu, Xu, Xu, Xu, Xu, Xu, Xu, Xu, Xu, Xu, Xu, Xu, Xu, Xu, Xu
Xos, Xu, Xos^Efs, Xos, Uh, Xos, Uh^Tf, Xos^Efs, Xos, Xos, Xos^Efs, Xos, Xos^Efs, Xos, Xos, Xos, Xos^Efs, Xos, Xos, Xu, Xu, Xu, Xos, Uue^Qhu, Uu^Es, Ur^Es, Ur^Es, Ur^Es, Ur, Uh^Qhh, Ur, Ur^Es, Wwg^Em, Xu, Ss^Emf, Xu, Xu, Xu, Xu, Xu, Xu, Xu, Uh^Tf, Wwg^Em, Xu, Xu, Xu, Xu, Xu, Xu, Xu, Xu, Xu, Xu, Xu, Xu, Xu, Xu, Xu, Xu, Xu, Xu
Xu, Xos, Uu, Uh, Uu^Tf, Uh^Emf, Uh^Em, Uu^Emf, Uu^Vud, Uu, Ur^Es, Ur^Ebn, Uu, Uu^Vud, Uu^Emf, Uu, Uu^Vud, Xos, Xos, Xos, Xos, Xos, Uh^Qhh, Uu^Pw\o, Xom, Xom, Ur, Uue^Qhu, Uue^Qhu, Ur, Uu, Wwg, Uu^Ebn, Wwg^Em, Xu, Xu, Xu, Xu, Xu, Xu, Xu, Xu, Xu, Xu, Xu, Xu, Xu, Xu, Xu, Xu, Xu, Xu, Xu, Xu, Xu, Xu, Xu, Xu, Xu, Xu, Xu, Xu
Xu, Xu, Uhe^Dr, Uu, Uu, Ce, Ce, Uu^Em, Uu, Uu, Uu, Ur, Ur^Es, Uu^Em, Uu, Ur^Es, Ur, Ur, Ur^Pr/, Xos, Uu^Vud, Uu^Ebn, Uh^Qhh, Uh^Qhh, Uu^Es, Xom, Ur^Es, Uue^Qhu, Uu^Es, Uu^Vud, Uu^Emf, Uu, Uh^Em, Xu, Xu, Xu, Xu, Xu, Xu, Xu, Xu, Xu, Xu, Xu, Xu, Xu, Xu, Xu, Xu, Xu, Xu, Xu, Cud, Urb^Ebn, Urb, Urb^Vud, Cud, Xu, Xu, Xu, Xu, Xu
Xu, Uhe^Dr, Uhe^Qhh, Ur, Ce, 1 Ke, Ce, Ur^Es, Ur^Es, Uu^Emf, Ur, Ur, Uu^Vud, Uu^Emf, Ur, Ur, Xos, Ur^Pr/, Ur^Es, Ur, Ur^Es, Ur, Ur^Es, Ur, Cud, Ur^Es, Uu, Uue^Qhu, Uu^Emf, Uue^Qhu, Uue^Qhu, Uu, Uu^Vud, Uh^Tf, Uh^Emf, Xu, Xu, Xu, Xu, Xu, Xu, Xu, Xu, Xu, Xu, Xu, Xu, Xu, Xu, Xu, Uu^Emf, Cud, Uu^Emf, Ur^Es, Ur^Es, Urb, Cud, Xu, Xu, Xu, Xu, Xu
Xu, Xu, Uhe^Dr, Uhe^Qhu, Uu^Emf, Ce, Uu, Uu, Ur, Ur, Xos, Xos, Xos, Xos, Xos, Uu^Vud, Xos, Xos, Xos, Ur, Uue^Qhu, Ur^Es, Ur, Cud, Cud, Ur^Es, Ur, Uu^Es, Uu^Emf, Uue^Qhu, Uu, Ur^Es, Uu^Es, Uu^Emf, Xu, Uh^Tf, Xu, Xu, Xu, Xu, Xu, Xu, Xu, Xu, Ur^Es, Xu, Uu^Tf, Uu^Ebn, Cud, Ur^Vud, Ur^Es, Uue^Qhu, Uue^Qhu, Cud, Urb, Urb, Urb, Cud, Xu, Xu, Xu, Xu
Xos, Uhe^Qhh, Uhe^Dr, Uh^Dr, Uh^Tf, Uh, Uh, Ur^Es, Xos, Xos, Xu, Xu, Xu, Xu, Xu, Xos, Xu, Xu, Xu, Xos, Xos, Uue^Qhu, Ur^Es, Ur^Es, Ur, Ur^Es, Ur^Es, Uu^Vud, Cud, Cud, Cud, Ur^Es, Uue^Qhu, Uue^Qhu, Uue^Qhu, Uh^Em, Uh^Emf, Xu, Urb^Ii, Xu, Xu, Xu, Uu^Em, Uu, Ur^Es, Uu^Emf, Uue^Qhu, Ur^Es, Uu, Uu, Ur, Uue^Qhu, Ur^Es, Ur, Cud, Urb, Urb, Urb^Vud, Cud, Xu, Xu, Xu
Xu, Xos, Xos, Xos, Xos, Uh^Emf, Xos, Xos, Xu, Xu, Xu, Xu, Xu, Xu, Xu, Xu, Xu, Xu, Xu, Xu, Xos, Xos, Uue^Ebn, Uu^Vud, Uu, Ur^Es, Ur^Es, Ur, Cud, 3 Kud, Cud, Ur^Es, Ur, Uue^Qhu, Ur^Es, Uu^Em, Uu, Uu, Ur, Xu, Xu, Xu, Uu, Uu, Uu, Ur^Edb, Ur^Edb, Ur^Es, Ur, Ur^Edb, Ur, Ur^Edb, Ur, Urb, Urb, Urb, Urb, Cud, 2 Kud, Xu, Xu, Xu
Xu, Xu, Xu, Xu, Xu, Xu, Xu, Xu, Xu, Xu, Xu, Xu, Xu, Xu, Xu, Xu, Xu, Xu, Xu, Xu, Xu, Xos, Sm^Qhu, Sm^Qhu, Uu, Ur, Uue^Qhu, Ur, Ur, Cud, Ur^Es, Ur, Uu, Ur, Uu^Ebn, Ur^Es, Ur, Ur, Urb^Ii, Xu, Xu, Xu, Uu^Tf, Uu^Em, Uue^Qhu, Ur^Es, Uu, Ur, Ur^Es, Ur^Edb, Ur, Ur^Es, Ur, Urb, Cud, Urb, Urb, Cud, Cud, Xu, Xu, Xu
Xu, Xu, Xu, Xu, Xu, Xu, Xu, Xu, Xu, Xu, Xu, Xu, Xu, Xu, Xu, Xu, Xu, Xu, Xu, Xu, Xu, Xu, Ss^Em, Sm^Qhu, Sm^Qhu, Uue^Qhu, Uue^Qhu, Ur, Ur^Es, Ur, Ur, Uu, Xu, Uu^Vud, Xu, Xu, Xu, Xu, Xu, Xu, Xu, Xu, Xu, Uue^Qhu, Uue^Qhu, Uu^Em, Uu^Emf, Uu, Cud, Uue^Qhu, Ur^Es, Ur^Edb, Uu, Ur^Es, Urb, Urb, Urb, Urb^Vud, Xu, Xu, Xu, Xu
Xu, Xu, Xu, Xu, Xu, Xu, Xu, Xu, Xu, Xu, Ur^Edb, Xu, Xu, Uu^Edb, Ur^Edb, Xu, Xu, Xu, Xu, Xu, Xu, Ss^Em, Ss^Emf, Uh^Em, Sm^Qhu, Uu^Es, Ur, Ur^Vu, Cud, Ur^Es, Uue^Qhu, Uu^Em, Sm^Qhu, Sm^Qhu, Xu, Xu, Xu, Xu, Xu, Xu, Xu, Xu, Xu, Xu, Xu, Xu, Xu, Uu^Ebn, Xu, Ur^Vud, Uu^Emf, Uu^Em, Uu^Emf, Cud, Ur^Es, Urb, Cud, Cud, Xu, Xu, Xu, Xu
Xu, Xu, Xu, Xu, Xu, Xu, Xu, Xu, Xu, Xu, Ur^Edb, Xu, Xuc, Ur^Edb, Ur^Pr/, Xu, Xuc, Xu, Xu, Xu, Uh^Tf, Sm^Vhs, Sm^Em, Xuc, Xuc, Rb^Es, Ur, Cud, Cud, Uue^Qhu, Uue^Qhu, Uu^Emf, Xuc, Uh^Em, Xu, Xu, Xu, Xu, Xu, Xu, Xu, Xu, Xu, Xu, Xu, Xu, Xu, Xu, Xu, Xu, Xu, Cud, Cud, Ur^Es, Urb, Urb, Cud, Xu, Xu, Xu, Xu, Xu
Xu, Xu, Xu, Xu, Xu, Xu, Xu, Xu, Xu, Xu, Xu, Ur^Pr/, Uh^Emf, Xuc, Ur^Br|, Uh^Emf, Xuc, Xu, Uh^Em, Xu, Uue^Qhu, Sm^Tf, Uue^Qhu, Xuc, Uu^Es, Rb^Es, Ur, Ur^Es, Rb^Es, Uue^Qhu, Uu^Es, Xuc, Xuc, Sm^Emf, Uh^Tf, Xu, Xu, Xu, Xu, Xu, Xu, Xu, Xu, Xu, Xu, Xu, Xu, Xu, Xu, Xu, Xu, Xu, Xu, Urb^Ebn, Xu, Urb^Vud, Xu, Xu, Xu, Xu, Xu, Xu
Xu, Xu, Xu, Xu, Xu, Xu, Xu, Xu, Xu, Xu, Uh^Emf, Ur^Br|, Ur^Br\, Uh^Em, Ur^Br/, Uu^Emf, Uu^Qhu, Xu, Uh, Uue^Qhu, Ur^Br/, Uh^Emf, Uh, Uue^Qhu, Uu^Em, Uu^Vud, Rb, Ur^Es, Rb^Es, Rb, Uu^Es, Uu^Es, Sm^Qhu, Uu^Es, Uh^Em, Uu^Vud, Xu, Xu, Xu, Xu, Ur^Edb, Xu, Xu, Xu, Xu, Xu, Xu, Xu, Xu, Xu, Xu, Xu, Xu, Xu, Xu, Xu, Xu, Xu, Xu, Xu, Xu, Xu
Xu, Xu, Xu, Xu, Xu, Xu, Xu, Xu, Xu, Uh^Vu, Xuc, Uu^Qhu, Ur^Br\, Ur^Br|, Xuc, Xuc, Ur^Br/, Ur^Br\, Ur^Br/, Ur^Br/, Uue^Qhu, Uh, Xu, Xu, Uu^Tf, Xu, Xu, Ur^Es, Ur, Ur, Uh^Qhh, Xu, Sm^Qhu, Ss^Emf, Ss^Tf, Xu, Xu, Xu, Xu, Xu, Xu, Uu, Xu, Xu, Xu, Xu, Xu, Xu, Xu, Xu, Xu, Xu, Xu, Xu, Xu, Xu, Xu, Xu, Xu, Xu, Xu, Xu
Xu, Xu, Xu, Xu, Xu, Xu, Xu, Xu, Xu, Uh^Tf, Ur^Br/, Ur^Br/, Uu^Qhu, Ur^Br\, Ur^Br/, Ur^Br/, Ur^Br|, Xuc, Ur^Br|, Uu^Qhh, Uh^Qhh, Uh^Emf, Uh^Tf, Xu, Xu, Uu^Emf, Ur^Es, Ur, Ss^Em, Uh^Qhh, Uh^Qhh, Sm^Qhu, Ss^Emf, Xu, Xu, Xu, Xu, Xu, Xu, Xu, Xu, Uu^Pr/, Uh^Vud, Xu, Xu, Xu, Ur^Edb, Xu, Xu, Xu, Xu, Xu, Xu, Xu, Xu, Xu, Xu, Xu, Xu, Xu, Xu, Xu
Xu, Xu, Xu, Xu, Xu, Xu, Xu, Xu, Ur, Ur^Pr\, Xu, Uu^Qhu, Xuc, Uu^Qhu, Uu^Qhu, Uu^Qhu, Ur^Br|, Uu^Qhu, Ur^Br\, Uu, Xu, Xu, Xu, Xu, Xu, Rb^Edb, Ur, Ss^Em, Ss^Em, Ss^Emf, Xu, Xu, Xu, Xu, Xu, Xu, Xu, Xu, Xu, Xu, Sm^Qhu, Uu^Es, Sm^Qhu, Uh^Emf, Uu^Em, Uu^Pr\, Xu, Ur^Edb, Xu, Xu, Xu, Xu, Xu, Xu, Xu, Xu, Xu, Xu, Xu, Xu, Xu, Xu
Xu, Xu, Xu, Xu, Xu, Xu, Xu, Xu, Uh^Emf, Xu, Xu, Uh^Emf, Uh^Tf, Xuc, Uh^Em, Uh^Vud, Ur^Br/, Uu^Qhu, Uu^Emf, Ur^Br\, Ur^Pr/, Xu, Xu, Xu, Xu, Xu, Cud, Ur, Ur^Es, Cud, Xu, Xu, Xu, Xu, Ur^Vu, Xu, Xu, Xu, Uh^Tf, Xu, Ss^Es, Ss, Xu, Sm^Qhu, Xu, Xu, Xu, Xu, Xu, Xu, Xu, Xu, Xu, Xu, Xu, Xu, Xu, Xu, Xu, Xu, Xu, Xu
Xu, Xu, Xu, Xu, Xu, Xu, Xu, Xu, Xu, Xu, Xu, Xu, Uh^Em, Uh^Tf, Uu^Qhu, Ur^Br|, Xu, Xu, Xu, Xu, Xu, Ur^Edb, Xu, Xu, Xu, Xu, Xu, Sm^Qhu, Rb, Rb^Edb, Uue^Em, Xu, Uue^Eb, Xu, Rb, Sm^Qhu, Sm^Qhu, Sm^Emf, Uh^Emf, Uh^Tf, Xu, Xu, Xu, Xu, Xu, Xu, Xu, Xu, Xu, Xu, Xu, Xu, Xu, Xu, Xu, Xu, Xu, Xu, Xu, Xu, Xu, Xu
Xu, Xu, Xu, Xu, Xu, Xu, Xu, Xu, Xu, Xu, Xu, Xu, Xu, Xu, Xu, Ur^Pr/, Ur, Xu, Xu, Xu, Xu, Ur^Edb, Xu, Xu, Xu, Xu, Ss^Emf, Sm^Qhu, Sm^Qhu, Rb^Edb, Ur, Uue^Emf, Ur^Es, Uu, Ur^Es, Sm^Qhu, Uu^Es, Ss^Bw/r, Ss^Emf, Xu, Xu, Xu, Xu, Xu, Xu, Xu, Xu, Xu, Xu, Xu, Xu, Xu, Xu, Xu, Xu, Xu, Xu, Xu, Xu, Xu, Xu, Xu
Xu, Xu, Xu, Xu, Xu, Xu, Xu, Xu, Xu, Xu, Xu, Xu, Xu, Xu, Xu, Xu, Ur^Edb, Xu, Xu, Xu, Xu, Xu, Xu, Xu, Xu, Xu, Xu, Sm^Qhu, Uh^Em, Uue, Rb, Ur^Edb, Rb, Ur, Cud, Cud, Cud, Uu^Es, Ss^Em, Xu, Xu, Xu, Xu, Xu, Ur, Xu, Xu, Xu, Xu, Xu, Xu, Xu, Xu, Xu, Xu, Xu, Xu, Xu, Xu, Xu, Xu, Xu
Xu, Xu, Xu, Xu, Xu, Xu, Xu, Xu, Xu, Xu, Xu, Xu, Xu, Xu, Xu, Xu, Xu, Xu, Xu, Xu, Xu, Xu, Xu, Xu, Xu, Xu, Xu, Uh^Vud, Uh^Tf, Uue^Em, Uue, Rb, Sm^Qhu, Rb^Es, Cud, 5 Kud, Cud, Rb^Em, Rb, Uu^Eb, Xu, Xu, Ur, Ur, Urb^Ii, Ur, Xu, Xu, Xu, Xu, Xu, Xu, Xu, Xu, Xu, Xu, Xu, Xu, Xu, Xu, Xu, Xu
Xu, Xu, Xu, Xu, Xu, Xu, Xu, Xu, Xu, Xu, Xu, Xu, Xu, Xu, Xu, Xu, Xu, Xu, Xu, Xu, Xu, Xu, Xu, Xu, Xu, Xu, Xu, Xu, Xu, Uh^Emf, Sm^Qhu, Rb, Sm^Qhu, Ss^Bw/r, Rb^Es, Cud, Uh^Em, Rb^Emf, Sm^Qhu, Rb, Ur, Ur^Pr\, Xu, Ur, Ur, Ur, Xu, Xu, Xu, Xu, Xu, Xu, Xu, Xu, Xu, Xu, Xu, Xu, Xu, Xu, Xu, Xu
Xu, Xu, Xu, Xu, Xu, Xu, Xu, Xu, Xu, Xu, Xu, Xu, Xu, Xu, Xu, Xu, Xu, Xu, Xu, Xu, Xu, Xu, Xu, Xu, Xu, Xu, Xu, Xu, Xu, Xu, Rb^Eb, Sm^Qhu, Ss^Emf, Ss^Em, Ss, Uue^Emf, Uh^Tf, Ss^Em, Uue^Emf, Rb^Em, Xu, Xu, Xu, Xu, Xu, Xu, Xu, Xu, Xu, Xu, Xu, Xu, Xu, Xu, Xu, Xu, Xu, Xu, Xu, Xu, Xu, Xu
Xu, Xu, Xu, Xu, Xu, Xu, Xu, Xu, Xu, Xu, Xu, Xu, Xu, Xu, Xu, Xu, Xu, Xu, Xu, Xu, Xu, Xu, Xu, Xu, Xu, Xu, Xu, Xu, Xu, Xu, Xu, Ss^Vhs, Xu, Xu, Xu, Uue^Emf, Xu, Uh^Tf, Xu, Uu^Vud, Xu, Xu, Xu, Xu, Xu, Xu, Xu, Xu, Xu, Xu, Xu, Xu, Xu, Xu, Xu, Xu, Xu, Xu, Xu, Xu, Xu, Xu
Xu, Xu, Xu, Xu, Xu, Xu, Xu, Xu, Xu, Xu, Xu, Xu, Xu, Xu, Xu, Xu, Xu, Xu, Xu, Xu, Xu, Xu, Xu, Xu, Xu, Xu, Xu, Xu, Xu, Xu, Xu, Xu, Xu, Xu, Xu, Xu, Xu, Xu, Xu, Xu, Xu, Xu, Xu, Xu, Xu, Xu, Xu, Xu, Xu, Xu, Xu, Xu, Xu, Xu, Xu, Xu, Xu, Xu, Xu, Xu, Xu, Xu
